"filename", "language", "C++", "C", "Ini", "HTML", "comment", "blank", "total"
"f:\Working\中医\中医装备代码8-20出差回\2023-12-9-SWD&XWTT\Drivers\BSP\Components\lan8742\lan8742.c", "C", 0, 361, 0, 0, 252, 73, 686
"f:\Working\中医\中医装备代码8-20出差回\2023-12-9-SWD&XWTT\Drivers\BSP\Components\lan8742\lan8742.h", "C++", 211, 0, 0, 0, 217, 43, 471
"f:\Working\中医\中医装备代码8-20出差回\2023-12-9-SWD&XWTT\Drivers\BSP\Components\mx25l256\mx25l256.h", "C++", 89, 0, 0, 0, 96, 45, 230
"f:\Working\中医\中医装备代码8-20出差回\2023-12-9-SWD&XWTT\Drivers\BSP\Components\mx25l256\stm32746g_qspi.c", "C", 0, 323, 0, 0, 231, 87, 641
"f:\Working\中医\中医装备代码8-20出差回\2023-12-9-SWD&XWTT\Drivers\BSP\Components\mx25l256\stm32746g_qspi.h", "C++", 33, 0, 0, 0, 83, 23, 139
"f:\Working\中医\中医装备代码8-20出差回\2023-12-9-SWD&XWTT\Drivers\BSP\Components\mx25l256\stm32h743i_eval_qspi.c", "C", 0, 494, 0, 0, 311, 138, 943
"f:\Working\中医\中医装备代码8-20出差回\2023-12-9-SWD&XWTT\Drivers\BSP\Components\mx25l256\stm32h743i_eval_qspi.h", "C++", 74, 0, 0, 0, 90, 29, 193
"f:\Working\中医\中医装备代码8-20出差回\2023-12-9-SWD&XWTT\Drivers\BSP\Components\mx25l256\w25q128fv.h", "C++", 49, 0, 0, 0, 89, 35, 173
"f:\Working\中医\中医装备代码8-20出差回\2023-12-9-SWD&XWTT\Drivers\BSP\Components\wt2003hx\Wt2003hx.c", "C", 0, 262, 0, 0, 61, 87, 410
"f:\Working\中医\中医装备代码8-20出差回\2023-12-9-SWD&XWTT\Drivers\BSP\Components\wt2003hx\Wt2003hx.h", "C++", 40, 0, 0, 0, 1, 10, 51
"f:\Working\中医\中医装备代码8-20出差回\2023-12-9-SWD&XWTT\Drivers\BSP\Components\wt2003hx\timer.c", "C", 0, 85, 0, 0, 27, 38, 150
"f:\Working\中医\中医装备代码8-20出差回\2023-12-9-SWD&XWTT\Drivers\BSP\Components\wt2003hx\timer.h", "C++", 12, 0, 0, 0, 27, 14, 53
"f:\Working\中医\中医装备代码8-20出差回\2023-12-9-SWD&XWTT\Drivers\CMSIS\Core\Include\cmsis_armcc.h", "C++", 380, 0, 0, 0, 353, 133, 866
"f:\Working\中医\中医装备代码8-20出差回\2023-12-9-SWD&XWTT\Drivers\CMSIS\Core\Include\cmsis_armclang.h", "C++", 940, 0, 0, 0, 585, 345, 1870
"f:\Working\中医\中医装备代码8-20出差回\2023-12-9-SWD&XWTT\Drivers\CMSIS\Core\Include\cmsis_compiler.h", "C++", 194, 0, 0, 0, 49, 24, 267
"f:\Working\中医\中医装备代码8-20出差回\2023-12-9-SWD&XWTT\Drivers\CMSIS\Core\Include\cmsis_gcc.h", "C++", 1117, 0, 0, 0, 603, 366, 2086
"f:\Working\中医\中医装备代码8-20出差回\2023-12-9-SWD&XWTT\Drivers\CMSIS\Core\Include\cmsis_iccarm.h", "C++", 747, 0, 0, 0, 43, 146, 936
"f:\Working\中医\中医装备代码8-20出差回\2023-12-9-SWD&XWTT\Drivers\CMSIS\Core\Include\cmsis_version.h", "C++", 13, 0, 0, 0, 23, 4, 40
"f:\Working\中医\中医装备代码8-20出差回\2023-12-9-SWD&XWTT\Drivers\CMSIS\Core\Include\core_armv8mbl.h", "C++", 1030, 0, 0, 0, 526, 363, 1919
"f:\Working\中医\中医装备代码8-20出差回\2023-12-9-SWD&XWTT\Drivers\CMSIS\Core\Include\core_armv8mml.h", "C++", 1685, 0, 0, 0, 651, 592, 2928
"f:\Working\中医\中医装备代码8-20出差回\2023-12-9-SWD&XWTT\Drivers\CMSIS\Core\Include\core_cm0.h", "C++", 442, 0, 0, 0, 326, 182, 950
"f:\Working\中医\中医装备代码8-20出差回\2023-12-9-SWD&XWTT\Drivers\CMSIS\Core\Include\core_cm0plus.h", "C++", 526, 0, 0, 0, 345, 213, 1084
"f:\Working\中医\中医装备代码8-20出差回\2023-12-9-SWD&XWTT\Drivers\CMSIS\Core\Include\core_cm1.h", "C++", 452, 0, 0, 0, 337, 188, 977
"f:\Working\中医\中医装备代码8-20出差回\2023-12-9-SWD&XWTT\Drivers\CMSIS\Core\Include\core_cm23.h", "C++", 1078, 0, 0, 0, 532, 384, 1994
"f:\Working\中医\中医装备代码8-20出差回\2023-12-9-SWD&XWTT\Drivers\CMSIS\Core\Include\core_cm3.h", "C++", 1052, 0, 0, 0, 470, 420, 1942
"f:\Working\中医\中医装备代码8-20出差回\2023-12-9-SWD&XWTT\Drivers\CMSIS\Core\Include\core_cm33.h", "C++", 1735, 0, 0, 0, 655, 613, 3003
"f:\Working\中医\中医装备代码8-20出差回\2023-12-9-SWD&XWTT\Drivers\CMSIS\Core\Include\core_cm4.h", "C++", 1186, 0, 0, 0, 486, 458, 2130
"f:\Working\中医\中医装备代码8-20出差回\2023-12-9-SWD&XWTT\Drivers\CMSIS\Core\Include\core_cm7.h", "C++", 1539, 0, 0, 0, 565, 568, 2672
"f:\Working\中医\中医装备代码8-20出差回\2023-12-9-SWD&XWTT\Drivers\CMSIS\Core\Include\core_sc000.h", "C++", 486, 0, 0, 0, 334, 203, 1023
"f:\Working\中医\中医装备代码8-20出差回\2023-12-9-SWD&XWTT\Drivers\CMSIS\Core\Include\core_sc300.h", "C++", 1035, 0, 0, 0, 468, 413, 1916
"f:\Working\中医\中医装备代码8-20出差回\2023-12-9-SWD&XWTT\Drivers\CMSIS\Core\Include\mpu_armv7.h", "C++", 120, 0, 0, 0, 125, 26, 271
"f:\Working\中医\中医装备代码8-20出差回\2023-12-9-SWD&XWTT\Drivers\CMSIS\Core\Include\mpu_armv8.h", "C++", 163, 0, 0, 0, 130, 41, 334
"f:\Working\中医\中医装备代码8-20出差回\2023-12-9-SWD&XWTT\Drivers\CMSIS\Core\Include\tz_context.h", "C++", 19, 0, 0, 0, 40, 12, 71
"f:\Working\中医\中医装备代码8-20出差回\2023-12-9-SWD&XWTT\Drivers\CMSIS\Core\Template\ARMv8-M\main_s.c", "C", 0, 16, 0, 0, 32, 11, 59
"f:\Working\中医\中医装备代码8-20出差回\2023-12-9-SWD&XWTT\Drivers\CMSIS\Core\Template\ARMv8-M\tz_context.c", "C", 0, 110, 0, 0, 44, 47, 201
"f:\Working\中医\中医装备代码8-20出差回\2023-12-9-SWD&XWTT\Drivers\CMSIS\Core_A\Include\cmsis_armcc.h", "C++", 287, 0, 0, 0, 198, 60, 545
"f:\Working\中医\中医装备代码8-20出差回\2023-12-9-SWD&XWTT\Drivers\CMSIS\Core_A\Include\cmsis_armclang.h", "C++", 247, 0, 0, 0, 200, 57, 504
"f:\Working\中医\中医装备代码8-20出差回\2023-12-9-SWD&XWTT\Drivers\CMSIS\Core_A\Include\cmsis_compiler.h", "C++", 129, 0, 0, 0, 49, 24, 202
"f:\Working\中医\中医装备代码8-20出差回\2023-12-9-SWD&XWTT\Drivers\CMSIS\Core_A\Include\cmsis_cp15.h", "C++", 240, 0, 0, 0, 223, 52, 515
"f:\Working\中医\中医装备代码8-20出差回\2023-12-9-SWD&XWTT\Drivers\CMSIS\Core_A\Include\cmsis_gcc.h", "C++", 373, 0, 0, 0, 232, 75, 680
"f:\Working\中医\中医装备代码8-20出差回\2023-12-9-SWD&XWTT\Drivers\CMSIS\Core_A\Include\cmsis_iccarm.h", "C++", 426, 0, 0, 0, 35, 99, 560
"f:\Working\中医\中医装备代码8-20出差回\2023-12-9-SWD&XWTT\Drivers\CMSIS\Core_A\Include\core_ca.h", "C++", 1724, 0, 0, 0, 559, 332, 2615
"f:\Working\中医\中医装备代码8-20出差回\2023-12-9-SWD&XWTT\Drivers\CMSIS\Core_A\Include\irq_ctrl.h", "C++", 69, 0, 0, 0, 85, 33, 187
"f:\Working\中医\中医装备代码8-20出差回\2023-12-9-SWD&XWTT\Drivers\CMSIS\Core_A\Source\irq_ctrl_gic.c", "C", 0, 241, 0, 0, 66, 104, 411
"f:\Working\中医\中医装备代码8-20出差回\2023-12-9-SWD&XWTT\Drivers\CMSIS\DSP\DSP_Lib_TestSuite\Common\JTest\inc\arr_desc\arr_desc.h", "C++", 101, 0, 0, 0, 98, 22, 221
"f:\Working\中医\中医装备代码8-20出差回\2023-12-9-SWD&XWTT\Drivers\CMSIS\DSP\DSP_Lib_TestSuite\Common\JTest\inc\jtest.h", "C++", 11, 0, 0, 0, 3, 4, 18
"f:\Working\中医\中医装备代码8-20出差回\2023-12-9-SWD&XWTT\Drivers\CMSIS\DSP\DSP_Lib_TestSuite\Common\JTest\inc\jtest_cycle.h", "C++", 25, 0, 0, 0, 34, 7, 66
"f:\Working\中医\中医装备代码8-20出差回\2023-12-9-SWD&XWTT\Drivers\CMSIS\DSP\DSP_Lib_TestSuite\Common\JTest\inc\jtest_define.h", "C++", 13, 0, 0, 0, 18, 7, 38
"f:\Working\中医\中医装备代码8-20出差回\2023-12-9-SWD&XWTT\Drivers\CMSIS\DSP\DSP_Lib_TestSuite\Common\JTest\inc\jtest_fw.h", "C++", 101, 0, 0, 0, 108, 45, 254
"f:\Working\中医\中医装备代码8-20出差回\2023-12-9-SWD&XWTT\Drivers\CMSIS\DSP\DSP_Lib_TestSuite\Common\JTest\inc\jtest_group.h", "C++", 25, 0, 0, 0, 29, 13, 67
"f:\Working\中医\中医装备代码8-20出差回\2023-12-9-SWD&XWTT\Drivers\CMSIS\DSP\DSP_Lib_TestSuite\Common\JTest\inc\jtest_group_call.h", "C++", 80, 0, 0, 0, 35, 12, 127
"f:\Working\中医\中医装备代码8-20出差回\2023-12-9-SWD&XWTT\Drivers\CMSIS\DSP\DSP_Lib_TestSuite\Common\JTest\inc\jtest_group_define.h", "C++", 33, 0, 0, 0, 37, 18, 88
"f:\Working\中医\中医装备代码8-20出差回\2023-12-9-SWD&XWTT\Drivers\CMSIS\DSP\DSP_Lib_TestSuite\Common\JTest\inc\jtest_pf.h", "C++", 27, 0, 0, 0, 42, 17, 86
"f:\Working\中医\中医装备代码8-20出差回\2023-12-9-SWD&XWTT\Drivers\CMSIS\DSP\DSP_Lib_TestSuite\Common\JTest\inc\jtest_systick.h", "C++", 59, 0, 0, 0, 25, 10, 94
"f:\Working\中医\中医装备代码8-20出差回\2023-12-9-SWD&XWTT\Drivers\CMSIS\DSP\DSP_Lib_TestSuite\Common\JTest\inc\jtest_test.h", "C++", 38, 0, 0, 0, 45, 18, 101
"f:\Working\中医\中医装备代码8-20出差回\2023-12-9-SWD&XWTT\Drivers\CMSIS\DSP\DSP_Lib_TestSuite\Common\JTest\inc\jtest_test_call.h", "C++", 76, 0, 0, 0, 36, 10, 122
"f:\Working\中医\中医装备代码8-20出差回\2023-12-9-SWD&XWTT\Drivers\CMSIS\DSP\DSP_Lib_TestSuite\Common\JTest\inc\jtest_test_define.h", "C++", 64, 0, 0, 0, 45, 25, 134
"f:\Working\中医\中医装备代码8-20出差回\2023-12-9-SWD&XWTT\Drivers\CMSIS\DSP\DSP_Lib_TestSuite\Common\JTest\inc\jtest_test_ret.h", "C++", 8, 0, 0, 0, 6, 4, 18
"f:\Working\中医\中医装备代码8-20出差回\2023-12-9-SWD&XWTT\Drivers\CMSIS\DSP\DSP_Lib_TestSuite\Common\JTest\inc\jtest_util.h", "C++", 11, 0, 0, 0, 10, 7, 28
"f:\Working\中医\中医装备代码8-20出差回\2023-12-9-SWD&XWTT\Drivers\CMSIS\DSP\DSP_Lib_TestSuite\Common\JTest\inc\opt_arg\opt_arg.h", "C++", 5, 0, 0, 0, 6, 5, 16
"f:\Working\中医\中医装备代码8-20出差回\2023-12-9-SWD&XWTT\Drivers\CMSIS\DSP\DSP_Lib_TestSuite\Common\JTest\inc\opt_arg\pp_narg.h", "C++", 23, 0, 0, 0, 0, 3, 26
"f:\Working\中医\中医装备代码8-20出差回\2023-12-9-SWD&XWTT\Drivers\CMSIS\DSP\DSP_Lib_TestSuite\Common\JTest\inc\opt_arg\splice.h", "C++", 6, 0, 0, 0, 0, 3, 9
"f:\Working\中医\中医装备代码8-20出差回\2023-12-9-SWD&XWTT\Drivers\CMSIS\DSP\DSP_Lib_TestSuite\Common\JTest\inc\util\util.h", "C++", 18, 0, 0, 0, 24, 11, 53
"f:\Working\中医\中医装备代码8-20出差回\2023-12-9-SWD&XWTT\Drivers\CMSIS\DSP\DSP_Lib_TestSuite\Common\JTest\src\jtest_cycle.c", "C", 0, 3, 0, 0, 4, 3, 10
"f:\Working\中医\中医装备代码8-20出差回\2023-12-9-SWD&XWTT\Drivers\CMSIS\DSP\DSP_Lib_TestSuite\Common\JTest\src\jtest_dump_str_segments.c", "C", 0, 27, 0, 0, 6, 4, 37
"f:\Working\中医\中医装备代码8-20出差回\2023-12-9-SWD&XWTT\Drivers\CMSIS\DSP\DSP_Lib_TestSuite\Common\JTest\src\jtest_fw.c", "C", 0, 3, 0, 0, 3, 4, 10
"f:\Working\中医\中医装备代码8-20出差回\2023-12-9-SWD&XWTT\Drivers\CMSIS\DSP\DSP_Lib_TestSuite\Common\JTest\src\jtest_trigger_action.c", "C", 0, 22, 0, 0, 7, 9, 38
"f:\Working\中医\中医装备代码8-20出差回\2023-12-9-SWD&XWTT\Drivers\CMSIS\DSP\DSP_Lib_TestSuite\Common\inc\all_tests.h", "C++", 4, 0, 0, 0, 3, 3, 10
"f:\Working\中医\中医装备代码8-20出差回\2023-12-9-SWD&XWTT\Drivers\CMSIS\DSP\DSP_Lib_TestSuite\Common\inc\basic_math_tests\basic_math_templates.h", "C++", 162, 0, 0, 0, 68, 38, 268
"f:\Working\中医\中医装备代码8-20出差回\2023-12-9-SWD&XWTT\Drivers\CMSIS\DSP\DSP_Lib_TestSuite\Common\inc\basic_math_tests\basic_math_test_data.h", "C++", 22, 0, 0, 0, 13, 12, 47
"f:\Working\中医\中医装备代码8-20出差回\2023-12-9-SWD&XWTT\Drivers\CMSIS\DSP\DSP_Lib_TestSuite\Common\inc\basic_math_tests\basic_math_test_group.h", "C++", 4, 0, 0, 0, 3, 3, 10
"f:\Working\中医\中医装备代码8-20出差回\2023-12-9-SWD&XWTT\Drivers\CMSIS\DSP\DSP_Lib_TestSuite\Common\inc\basic_math_tests\basic_math_tests.h", "C++", 12, 0, 0, 0, 3, 3, 18
"f:\Working\中医\中医装备代码8-20出差回\2023-12-9-SWD&XWTT\Drivers\CMSIS\DSP\DSP_Lib_TestSuite\Common\inc\complex_math_tests\complex_math_templates.h", "C++", 120, 0, 0, 0, 74, 29, 223
"f:\Working\中医\中医装备代码8-20出差回\2023-12-9-SWD&XWTT\Drivers\CMSIS\DSP\DSP_Lib_TestSuite\Common\inc\complex_math_tests\complex_math_test_data.h", "C++", 25, 0, 0, 0, 12, 14, 51
"f:\Working\中医\中医装备代码8-20出差回\2023-12-9-SWD&XWTT\Drivers\CMSIS\DSP\DSP_Lib_TestSuite\Common\inc\complex_math_tests\complex_math_test_group.h", "C++", 4, 0, 0, 0, 3, 3, 10
"f:\Working\中医\中医装备代码8-20出差回\2023-12-9-SWD&XWTT\Drivers\CMSIS\DSP\DSP_Lib_TestSuite\Common\inc\complex_math_tests\complex_math_tests.h", "C++", 9, 0, 0, 0, 3, 3, 15
"f:\Working\中医\中医装备代码8-20出差回\2023-12-9-SWD&XWTT\Drivers\CMSIS\DSP\DSP_Lib_TestSuite\Common\inc\controller_tests\controller_templates.h", "C++", 22, 0, 0, 0, 16, 9, 47
"f:\Working\中医\中医装备代码8-20出差回\2023-12-9-SWD&XWTT\Drivers\CMSIS\DSP\DSP_Lib_TestSuite\Common\inc\controller_tests\controller_test_data.h", "C++", 17, 0, 0, 0, 9, 8, 34
"f:\Working\中医\中医装备代码8-20出差回\2023-12-9-SWD&XWTT\Drivers\CMSIS\DSP\DSP_Lib_TestSuite\Common\inc\controller_tests\controller_test_group.h", "C++", 4, 0, 0, 0, 3, 3, 10
"f:\Working\中医\中医装备代码8-20出差回\2023-12-9-SWD&XWTT\Drivers\CMSIS\DSP\DSP_Lib_TestSuite\Common\inc\controller_tests\controller_tests.h", "C++", 6, 0, 0, 0, 3, 3, 12
"f:\Working\中医\中医装备代码8-20出差回\2023-12-9-SWD&XWTT\Drivers\CMSIS\DSP\DSP_Lib_TestSuite\Common\inc\fast_math_tests\fast_math_templates.h", "C++", 75, 0, 0, 0, 16, 12, 103
"f:\Working\中医\中医装备代码8-20出差回\2023-12-9-SWD&XWTT\Drivers\CMSIS\DSP\DSP_Lib_TestSuite\Common\inc\fast_math_tests\fast_math_test_data.h", "C++", 13, 0, 0, 0, 9, 8, 30
"f:\Working\中医\中医装备代码8-20出差回\2023-12-9-SWD&XWTT\Drivers\CMSIS\DSP\DSP_Lib_TestSuite\Common\inc\fast_math_tests\fast_math_test_group.h", "C++", 4, 0, 0, 0, 3, 3, 10
"f:\Working\中医\中医装备代码8-20出差回\2023-12-9-SWD&XWTT\Drivers\CMSIS\DSP\DSP_Lib_TestSuite\Common\inc\filtering_tests\filtering_templates.h", "C++", 38, 0, 0, 0, 41, 13, 92
"f:\Working\中医\中医装备代码8-20出差回\2023-12-9-SWD&XWTT\Drivers\CMSIS\DSP\DSP_Lib_TestSuite\Common\inc\filtering_tests\filtering_test_data.h", "C++", 53, 0, 0, 0, 15, 14, 82
"f:\Working\中医\中医装备代码8-20出差回\2023-12-9-SWD&XWTT\Drivers\CMSIS\DSP\DSP_Lib_TestSuite\Common\inc\filtering_tests\filtering_test_group.h", "C++", 4, 0, 0, 0, 3, 3, 10
"f:\Working\中医\中医装备代码8-20出差回\2023-12-9-SWD&XWTT\Drivers\CMSIS\DSP\DSP_Lib_TestSuite\Common\inc\filtering_tests\filtering_tests.h", "C++", 9, 0, 0, 0, 3, 4, 16
"f:\Working\中医\中医装备代码8-20出差回\2023-12-9-SWD&XWTT\Drivers\CMSIS\DSP\DSP_Lib_TestSuite\Common\inc\intrinsics_tests\intrinsics_templates.h", "C++", 138, 0, 0, 0, 16, 13, 167
"f:\Working\中医\中医装备代码8-20出差回\2023-12-9-SWD&XWTT\Drivers\CMSIS\DSP\DSP_Lib_TestSuite\Common\inc\intrinsics_tests\intrinsics_test_data.h", "C++", 11, 0, 0, 0, 9, 8, 28
"f:\Working\中医\中医装备代码8-20出差回\2023-12-9-SWD&XWTT\Drivers\CMSIS\DSP\DSP_Lib_TestSuite\Common\inc\intrinsics_tests\intrinsics_test_group.h", "C++", 4, 0, 0, 0, 3, 3, 10
"f:\Working\中医\中医装备代码8-20出差回\2023-12-9-SWD&XWTT\Drivers\CMSIS\DSP\DSP_Lib_TestSuite\Common\inc\math_helper.h", "C++", 19, 0, 0, 0, 30, 4, 53
"f:\Working\中医\中医装备代码8-20出差回\2023-12-9-SWD&XWTT\Drivers\CMSIS\DSP\DSP_Lib_TestSuite\Common\inc\matrix_tests\matrix_templates.h", "C++", 269, 0, 0, 0, 62, 40, 371
"f:\Working\中医\中医装备代码8-20出差回\2023-12-9-SWD&XWTT\Drivers\CMSIS\DSP\DSP_Lib_TestSuite\Common\inc\matrix_tests\matrix_test_data.h", "C++", 30, 0, 0, 0, 14, 11, 55
"f:\Working\中医\中医装备代码8-20出差回\2023-12-9-SWD&XWTT\Drivers\CMSIS\DSP\DSP_Lib_TestSuite\Common\inc\matrix_tests\matrix_test_group.h", "C++", 4, 0, 0, 0, 3, 3, 10
"f:\Working\中医\中医装备代码8-20出差回\2023-12-9-SWD&XWTT\Drivers\CMSIS\DSP\DSP_Lib_TestSuite\Common\inc\matrix_tests\matrix_tests.h", "C++", 12, 0, 0, 0, 3, 3, 18
"f:\Working\中医\中医装备代码8-20出差回\2023-12-9-SWD&XWTT\Drivers\CMSIS\DSP\DSP_Lib_TestSuite\Common\inc\statistics_tests\statistics_templates.h", "C++", 86, 0, 0, 0, 43, 29, 158
"f:\Working\中医\中医装备代码8-20出差回\2023-12-9-SWD&XWTT\Drivers\CMSIS\DSP\DSP_Lib_TestSuite\Common\inc\statistics_tests\statistics_test_data.h", "C++", 21, 0, 0, 0, 12, 12, 45
"f:\Working\中医\中医装备代码8-20出差回\2023-12-9-SWD&XWTT\Drivers\CMSIS\DSP\DSP_Lib_TestSuite\Common\inc\statistics_tests\statistics_test_group.h", "C++", 4, 0, 0, 0, 3, 3, 10
"f:\Working\中医\中医装备代码8-20出差回\2023-12-9-SWD&XWTT\Drivers\CMSIS\DSP\DSP_Lib_TestSuite\Common\inc\statistics_tests\statistics_tests.h", "C++", 10, 0, 0, 0, 3, 3, 16
"f:\Working\中医\中医装备代码8-20出差回\2023-12-9-SWD&XWTT\Drivers\CMSIS\DSP\DSP_Lib_TestSuite\Common\inc\support_tests\support_templates.h", "C++", 63, 0, 0, 0, 41, 17, 121
"f:\Working\中医\中医装备代码8-20出差回\2023-12-9-SWD&XWTT\Drivers\CMSIS\DSP\DSP_Lib_TestSuite\Common\inc\support_tests\support_test_data.h", "C++", 13, 0, 0, 0, 10, 9, 32
"f:\Working\中医\中医装备代码8-20出差回\2023-12-9-SWD&XWTT\Drivers\CMSIS\DSP\DSP_Lib_TestSuite\Common\inc\support_tests\support_test_group.h", "C++", 4, 0, 0, 0, 3, 3, 10
"f:\Working\中医\中医装备代码8-20出差回\2023-12-9-SWD&XWTT\Drivers\CMSIS\DSP\DSP_Lib_TestSuite\Common\inc\support_tests\support_tests.h", "C++", 6, 0, 0, 0, 3, 3, 12
"f:\Working\中医\中医装备代码8-20出差回\2023-12-9-SWD&XWTT\Drivers\CMSIS\DSP\DSP_Lib_TestSuite\Common\inc\templates\template.h", "C++", 48, 0, 0, 0, 31, 10, 89
"f:\Working\中医\中医装备代码8-20出差回\2023-12-9-SWD&XWTT\Drivers\CMSIS\DSP\DSP_Lib_TestSuite\Common\inc\templates\test_templates.h", "C++", 330, 0, 0, 0, 102, 27, 459
"f:\Working\中医\中医装备代码8-20出差回\2023-12-9-SWD&XWTT\Drivers\CMSIS\DSP\DSP_Lib_TestSuite\Common\inc\transform_tests\transform_templates.h", "C++", 114, 0, 0, 0, 53, 15, 182
"f:\Working\中医\中医装备代码8-20出差回\2023-12-9-SWD&XWTT\Drivers\CMSIS\DSP\DSP_Lib_TestSuite\Common\inc\transform_tests\transform_test_data.h", "C++", 27, 0, 0, 0, 12, 10, 49
"f:\Working\中医\中医装备代码8-20出差回\2023-12-9-SWD&XWTT\Drivers\CMSIS\DSP\DSP_Lib_TestSuite\Common\inc\transform_tests\transform_test_group.h", "C++", 4, 0, 0, 0, 3, 3, 10
"f:\Working\中医\中医装备代码8-20出差回\2023-12-9-SWD&XWTT\Drivers\CMSIS\DSP\DSP_Lib_TestSuite\Common\inc\transform_tests\transform_tests.h", "C++", 8, 0, 0, 0, 3, 3, 14
"f:\Working\中医\中医装备代码8-20出差回\2023-12-9-SWD&XWTT\Drivers\CMSIS\DSP\DSP_Lib_TestSuite\Common\inc\type_abbrev.h", "C++", 17, 0, 0, 0, 14, 7, 38
"f:\Working\中医\中医装备代码8-20出差回\2023-12-9-SWD&XWTT\Drivers\CMSIS\DSP\DSP_Lib_TestSuite\Common\platform\ARMCC\Retarget.c", "C", 0, 22, 0, 0, 15, 16, 53
"f:\Working\中医\中医装备代码8-20出差回\2023-12-9-SWD&XWTT\Drivers\CMSIS\DSP\DSP_Lib_TestSuite\Common\platform\GCC\Retarget.c", "C", 0, 69, 0, 0, 15, 23, 107
"f:\Working\中医\中医装备代码8-20出差回\2023-12-9-SWD&XWTT\Drivers\CMSIS\DSP\DSP_Lib_TestSuite\Common\platform\system_ARMCM0.c", "C", 0, 13, 0, 0, 35, 9, 57
"f:\Working\中医\中医装备代码8-20出差回\2023-12-9-SWD&XWTT\Drivers\CMSIS\DSP\DSP_Lib_TestSuite\Common\platform\system_ARMCM23.c", "C", 0, 31, 0, 0, 38, 14, 83
"f:\Working\中医\中医装备代码8-20出差回\2023-12-9-SWD&XWTT\Drivers\CMSIS\DSP\DSP_Lib_TestSuite\Common\platform\system_ARMCM3.c", "C", 0, 19, 0, 0, 38, 12, 69
"f:\Working\中医\中医装备代码8-20出差回\2023-12-9-SWD&XWTT\Drivers\CMSIS\DSP\DSP_Lib_TestSuite\Common\platform\system_ARMCM33.c", "C", 0, 45, 0, 0, 38, 17, 100
"f:\Working\中医\中医装备代码8-20出差回\2023-12-9-SWD&XWTT\Drivers\CMSIS\DSP\DSP_Lib_TestSuite\Common\platform\system_ARMCM4.c", "C", 0, 32, 0, 0, 38, 14, 84
"f:\Working\中医\中医装备代码8-20出差回\2023-12-9-SWD&XWTT\Drivers\CMSIS\DSP\DSP_Lib_TestSuite\Common\platform\system_ARMCM7.c", "C", 0, 34, 0, 0, 38, 14, 86
"f:\Working\中医\中医装备代码8-20出差回\2023-12-9-SWD&XWTT\Drivers\CMSIS\DSP\DSP_Lib_TestSuite\Common\platform\system_ARMSC000.c", "C", 0, 13, 0, 0, 35, 9, 57
"f:\Working\中医\中医装备代码8-20出差回\2023-12-9-SWD&XWTT\Drivers\CMSIS\DSP\DSP_Lib_TestSuite\Common\platform\system_ARMSC300.c", "C", 0, 22, 0, 0, 38, 13, 73
"f:\Working\中医\中医装备代码8-20出差回\2023-12-9-SWD&XWTT\Drivers\CMSIS\DSP\DSP_Lib_TestSuite\Common\platform\system_ARMv8MBL.c", "C", 0, 25, 0, 0, 38, 14, 77
"f:\Working\中医\中医装备代码8-20出差回\2023-12-9-SWD&XWTT\Drivers\CMSIS\DSP\DSP_Lib_TestSuite\Common\platform\system_ARMv8MML.c", "C", 0, 46, 0, 0, 38, 16, 100
"f:\Working\中医\中医装备代码8-20出差回\2023-12-9-SWD&XWTT\Drivers\CMSIS\DSP\DSP_Lib_TestSuite\Common\platform\system_generic.c", "C", 0, 19, 0, 0, 0, 9, 28
"f:\Working\中医\中医装备代码8-20出差回\2023-12-9-SWD&XWTT\Drivers\CMSIS\DSP\DSP_Lib_TestSuite\Common\src\all_tests.c", "C", 0, 25, 0, 0, 3, 3, 31
"f:\Working\中医\中医装备代码8-20出差回\2023-12-9-SWD&XWTT\Drivers\CMSIS\DSP\DSP_Lib_TestSuite\Common\src\basic_math_tests\abs_tests.c", "C", 0, 25, 0, 0, 3, 5, 33
"f:\Working\中医\中医装备代码8-20出差回\2023-12-9-SWD&XWTT\Drivers\CMSIS\DSP\DSP_Lib_TestSuite\Common\src\basic_math_tests\add_tests.c", "C", 0, 26, 0, 0, 3, 5, 34
"f:\Working\中医\中医装备代码8-20出差回\2023-12-9-SWD&XWTT\Drivers\CMSIS\DSP\DSP_Lib_TestSuite\Common\src\basic_math_tests\basic_math_test_common_data.c", "C", 0, 60, 0, 0, 22, 20, 102
"f:\Working\中医\中医装备代码8-20出差回\2023-12-9-SWD&XWTT\Drivers\CMSIS\DSP\DSP_Lib_TestSuite\Common\src\basic_math_tests\basic_math_test_group.c", "C", 0, 15, 0, 0, 0, 3, 18
"f:\Working\中医\中医装备代码8-20出差回\2023-12-9-SWD&XWTT\Drivers\CMSIS\DSP\DSP_Lib_TestSuite\Common\src\basic_math_tests\dot_prod_tests.c", "C", 0, 26, 0, 0, 3, 5, 34
"f:\Working\中医\中医装备代码8-20出差回\2023-12-9-SWD&XWTT\Drivers\CMSIS\DSP\DSP_Lib_TestSuite\Common\src\basic_math_tests\mult_tests.c", "C", 0, 26, 0, 0, 3, 5, 34
"f:\Working\中医\中医装备代码8-20出差回\2023-12-9-SWD&XWTT\Drivers\CMSIS\DSP\DSP_Lib_TestSuite\Common\src\basic_math_tests\negate_tests.c", "C", 0, 25, 0, 0, 3, 5, 33
"f:\Working\中医\中医装备代码8-20出差回\2023-12-9-SWD&XWTT\Drivers\CMSIS\DSP\DSP_Lib_TestSuite\Common\src\basic_math_tests\offset_tests.c", "C", 0, 26, 0, 0, 3, 5, 34
"f:\Working\中医\中医装备代码8-20出差回\2023-12-9-SWD&XWTT\Drivers\CMSIS\DSP\DSP_Lib_TestSuite\Common\src\basic_math_tests\scale_tests.c", "C", 0, 42, 0, 0, 4, 7, 53
"f:\Working\中医\中医装备代码8-20出差回\2023-12-9-SWD&XWTT\Drivers\CMSIS\DSP\DSP_Lib_TestSuite\Common\src\basic_math_tests\shift_tests.c", "C", 0, 24, 0, 0, 3, 5, 32
"f:\Working\中医\中医装备代码8-20出差回\2023-12-9-SWD&XWTT\Drivers\CMSIS\DSP\DSP_Lib_TestSuite\Common\src\basic_math_tests\sub_tests.c", "C", 0, 26, 0, 0, 3, 5, 34
"f:\Working\中医\中医装备代码8-20出差回\2023-12-9-SWD&XWTT\Drivers\CMSIS\DSP\DSP_Lib_TestSuite\Common\src\complex_math_tests\cmplx_conj_tests.c", "C", 0, 24, 0, 0, 3, 5, 32
"f:\Working\中医\中医装备代码8-20出差回\2023-12-9-SWD&XWTT\Drivers\CMSIS\DSP\DSP_Lib_TestSuite\Common\src\complex_math_tests\cmplx_dot_prod_tests.c", "C", 0, 24, 0, 0, 3, 5, 32
"f:\Working\中医\中医装备代码8-20出差回\2023-12-9-SWD&XWTT\Drivers\CMSIS\DSP\DSP_Lib_TestSuite\Common\src\complex_math_tests\cmplx_mag_squared_tests.c", "C", 0, 24, 0, 0, 3, 5, 32
"f:\Working\中医\中医装备代码8-20出差回\2023-12-9-SWD&XWTT\Drivers\CMSIS\DSP\DSP_Lib_TestSuite\Common\src\complex_math_tests\cmplx_mag_tests.c", "C", 0, 24, 0, 0, 3, 5, 32
"f:\Working\中医\中医装备代码8-20出差回\2023-12-9-SWD&XWTT\Drivers\CMSIS\DSP\DSP_Lib_TestSuite\Common\src\complex_math_tests\cmplx_mult_cmplx_tests.c", "C", 0, 24, 0, 0, 3, 5, 32
"f:\Working\中医\中医装备代码8-20出差回\2023-12-9-SWD&XWTT\Drivers\CMSIS\DSP\DSP_Lib_TestSuite\Common\src\complex_math_tests\cmplx_mult_real_test.c", "C", 0, 24, 0, 0, 3, 5, 32
"f:\Working\中医\中医装备代码8-20出差回\2023-12-9-SWD&XWTT\Drivers\CMSIS\DSP\DSP_Lib_TestSuite\Common\src\complex_math_tests\complex_math_test_common_data.c", "C", 0, 85, 0, 0, 10, 20, 115
"f:\Working\中医\中医装备代码8-20出差回\2023-12-9-SWD&XWTT\Drivers\CMSIS\DSP\DSP_Lib_TestSuite\Common\src\complex_math_tests\complex_math_test_group.c", "C", 0, 12, 0, 0, 0, 3, 15
"f:\Working\中医\中医装备代码8-20出差回\2023-12-9-SWD&XWTT\Drivers\CMSIS\DSP\DSP_Lib_TestSuite\Common\src\controller_tests\controller_test_common_data.c", "C", 0, 484, 0, 0, 6, 10, 500
"f:\Working\中医\中医装备代码8-20出差回\2023-12-9-SWD&XWTT\Drivers\CMSIS\DSP\DSP_Lib_TestSuite\Common\src\controller_tests\controller_test_group.c", "C", 0, 9, 0, 0, 3, 2, 14
"f:\Working\中医\中医装备代码8-20出差回\2023-12-9-SWD&XWTT\Drivers\CMSIS\DSP\DSP_Lib_TestSuite\Common\src\controller_tests\pid_reset_tests.c", "C", 0, 36, 0, 0, 11, 6, 53
"f:\Working\中医\中医装备代码8-20出差回\2023-12-9-SWD&XWTT\Drivers\CMSIS\DSP\DSP_Lib_TestSuite\Common\src\controller_tests\pid_tests.c", "C", 0, 65, 0, 0, 10, 5, 80
"f:\Working\中医\中医装备代码8-20出差回\2023-12-9-SWD&XWTT\Drivers\CMSIS\DSP\DSP_Lib_TestSuite\Common\src\controller_tests\sin_cos_tests.c", "C", 0, 100, 0, 0, 34, 18, 152
"f:\Working\中医\中医装备代码8-20出差回\2023-12-9-SWD&XWTT\Drivers\CMSIS\DSP\DSP_Lib_TestSuite\Common\src\fast_math_tests\fast_math_tests.c", "C", 0, 25, 0, 0, 6, 8, 39
"f:\Working\中医\中医装备代码8-20出差回\2023-12-9-SWD&XWTT\Drivers\CMSIS\DSP\DSP_Lib_TestSuite\Common\src\fast_math_tests\fast_math_tests_common_data.c", "C", 0, 354, 0, 0, 5, 6, 365
"f:\Working\中医\中医装备代码8-20出差回\2023-12-9-SWD&XWTT\Drivers\CMSIS\DSP\DSP_Lib_TestSuite\Common\src\filtering_tests\biquad_tests.c", "C", 0, 211, 0, 0, 10, 24, 245
"f:\Working\中医\中医装备代码8-20出差回\2023-12-9-SWD&XWTT\Drivers\CMSIS\DSP\DSP_Lib_TestSuite\Common\src\filtering_tests\conv_tests.c", "C", 0, 348, 0, 0, 78, 48, 474
"f:\Working\中医\中医装备代码8-20出差回\2023-12-9-SWD&XWTT\Drivers\CMSIS\DSP\DSP_Lib_TestSuite\Common\src\filtering_tests\correlate_tests.c", "C", 0, 203, 0, 0, 74, 34, 311
"f:\Working\中医\中医装备代码8-20出差回\2023-12-9-SWD&XWTT\Drivers\CMSIS\DSP\DSP_Lib_TestSuite\Common\src\filtering_tests\filtering_test_common_data.c", "C", 0, 702, 0, 0, 26, 30, 758
"f:\Working\中医\中医装备代码8-20出差回\2023-12-9-SWD&XWTT\Drivers\CMSIS\DSP\DSP_Lib_TestSuite\Common\src\filtering_tests\filtering_test_group.c", "C", 0, 12, 0, 0, 3, 3, 18
"f:\Working\中医\中医装备代码8-20出差回\2023-12-9-SWD&XWTT\Drivers\CMSIS\DSP\DSP_Lib_TestSuite\Common\src\filtering_tests\fir_tests.c", "C", 0, 378, 0, 0, 6, 19, 403
"f:\Working\中医\中医装备代码8-20出差回\2023-12-9-SWD&XWTT\Drivers\CMSIS\DSP\DSP_Lib_TestSuite\Common\src\filtering_tests\iir_tests.c", "C", 0, 66, 0, 0, 6, 5, 77
"f:\Working\中医\中医装备代码8-20出差回\2023-12-9-SWD&XWTT\Drivers\CMSIS\DSP\DSP_Lib_TestSuite\Common\src\filtering_tests\lms_tests.c", "C", 0, 205, 0, 0, 6, 9, 220
"f:\Working\中医\中医装备代码8-20出差回\2023-12-9-SWD&XWTT\Drivers\CMSIS\DSP\DSP_Lib_TestSuite\Common\src\intrinsics_tests\intrinsics_tests.c", "C", 0, 53, 0, 0, 6, 4, 63
"f:\Working\中医\中医装备代码8-20出差回\2023-12-9-SWD&XWTT\Drivers\CMSIS\DSP\DSP_Lib_TestSuite\Common\src\intrinsics_tests\intrinsics_tests_common_data.c", "C", 0, 180, 0, 0, 5, 5, 190
"f:\Working\中医\中医装备代码8-20出差回\2023-12-9-SWD&XWTT\Drivers\CMSIS\DSP\DSP_Lib_TestSuite\Common\src\main.c", "C", 0, 19, 0, 0, 0, 9, 28
"f:\Working\中医\中医装备代码8-20出差回\2023-12-9-SWD&XWTT\Drivers\CMSIS\DSP\DSP_Lib_TestSuite\Common\src\math_helper.c", "C", 0, 246, 0, 0, 150, 96, 492
"f:\Working\中医\中医装备代码8-20出差回\2023-12-9-SWD&XWTT\Drivers\CMSIS\DSP\DSP_Lib_TestSuite\Common\src\matrix_tests\mat_add_tests.c", "C", 0, 24, 0, 0, 3, 5, 32
"f:\Working\中医\中医装备代码8-20出差回\2023-12-9-SWD&XWTT\Drivers\CMSIS\DSP\DSP_Lib_TestSuite\Common\src\matrix_tests\mat_cmplx_mult_tests.c", "C", 0, 43, 0, 0, 9, 8, 60
"f:\Working\中医\中医装备代码8-20出差回\2023-12-9-SWD&XWTT\Drivers\CMSIS\DSP\DSP_Lib_TestSuite\Common\src\matrix_tests\mat_init_tests.c", "C", 0, 48, 0, 0, 6, 5, 59
"f:\Working\中医\中医装备代码8-20出差回\2023-12-9-SWD&XWTT\Drivers\CMSIS\DSP\DSP_Lib_TestSuite\Common\src\matrix_tests\mat_inverse_tests.c", "C", 0, 64, 0, 0, 10, 19, 93
"f:\Working\中医\中医装备代码8-20出差回\2023-12-9-SWD&XWTT\Drivers\CMSIS\DSP\DSP_Lib_TestSuite\Common\src\matrix_tests\mat_mult_fast_tests.c", "C", 0, 41, 0, 0, 9, 8, 58
"f:\Working\中医\中医装备代码8-20出差回\2023-12-9-SWD&XWTT\Drivers\CMSIS\DSP\DSP_Lib_TestSuite\Common\src\matrix_tests\mat_mult_tests.c", "C", 0, 43, 0, 0, 9, 8, 60
"f:\Working\中医\中医装备代码8-20出差回\2023-12-9-SWD&XWTT\Drivers\CMSIS\DSP\DSP_Lib_TestSuite\Common\src\matrix_tests\mat_scale_tests.c", "C", 0, 73, 0, 0, 7, 11, 91
"f:\Working\中医\中医装备代码8-20出差回\2023-12-9-SWD&XWTT\Drivers\CMSIS\DSP\DSP_Lib_TestSuite\Common\src\matrix_tests\mat_sub_tests.c", "C", 0, 24, 0, 0, 6, 5, 35
"f:\Working\中医\中医装备代码8-20出差回\2023-12-9-SWD&XWTT\Drivers\CMSIS\DSP\DSP_Lib_TestSuite\Common\src\matrix_tests\mat_trans_tests.c", "C", 0, 23, 0, 0, 6, 5, 34
"f:\Working\中医\中医装备代码8-20出差回\2023-12-9-SWD&XWTT\Drivers\CMSIS\DSP\DSP_Lib_TestSuite\Common\src\matrix_tests\matrix_test_common_data.c", "C", 0, 196, 0, 0, 38, 22, 256
"f:\Working\中医\中医装备代码8-20出差回\2023-12-9-SWD&XWTT\Drivers\CMSIS\DSP\DSP_Lib_TestSuite\Common\src\matrix_tests\matrix_test_group.c", "C", 0, 15, 0, 0, 3, 2, 20
"f:\Working\中医\中医装备代码8-20出差回\2023-12-9-SWD&XWTT\Drivers\CMSIS\DSP\DSP_Lib_TestSuite\Common\src\statistics_tests\max_tests.c", "C", 0, 26, 0, 0, 6, 5, 37
"f:\Working\中医\中医装备代码8-20出差回\2023-12-9-SWD&XWTT\Drivers\CMSIS\DSP\DSP_Lib_TestSuite\Common\src\statistics_tests\mean_tests.c", "C", 0, 26, 0, 0, 6, 5, 37
"f:\Working\中医\中医装备代码8-20出差回\2023-12-9-SWD&XWTT\Drivers\CMSIS\DSP\DSP_Lib_TestSuite\Common\src\statistics_tests\min_tests.c", "C", 0, 26, 0, 0, 6, 5, 37
"f:\Working\中医\中医装备代码8-20出差回\2023-12-9-SWD&XWTT\Drivers\CMSIS\DSP\DSP_Lib_TestSuite\Common\src\statistics_tests\power_tests.c", "C", 0, 26, 0, 0, 6, 5, 37
"f:\Working\中医\中医装备代码8-20出差回\2023-12-9-SWD&XWTT\Drivers\CMSIS\DSP\DSP_Lib_TestSuite\Common\src\statistics_tests\rms_tests.c", "C", 0, 24, 0, 0, 6, 5, 35
"f:\Working\中医\中医装备代码8-20出差回\2023-12-9-SWD&XWTT\Drivers\CMSIS\DSP\DSP_Lib_TestSuite\Common\src\statistics_tests\statistics_test_common_data.c", "C", 0, 62, 0, 0, 14, 19, 95
"f:\Working\中医\中医装备代码8-20出差回\2023-12-9-SWD&XWTT\Drivers\CMSIS\DSP\DSP_Lib_TestSuite\Common\src\statistics_tests\statistics_test_group.c", "C", 0, 13, 0, 0, 0, 2, 15
"f:\Working\中医\中医装备代码8-20出差回\2023-12-9-SWD&XWTT\Drivers\CMSIS\DSP\DSP_Lib_TestSuite\Common\src\statistics_tests\std_tests.c", "C", 0, 24, 0, 0, 6, 5, 35
"f:\Working\中医\中医装备代码8-20出差回\2023-12-9-SWD&XWTT\Drivers\CMSIS\DSP\DSP_Lib_TestSuite\Common\src\statistics_tests\var_tests.c", "C", 0, 24, 0, 0, 6, 5, 35
"f:\Working\中医\中医装备代码8-20出差回\2023-12-9-SWD&XWTT\Drivers\CMSIS\DSP\DSP_Lib_TestSuite\Common\src\support_tests\copy_tests.c", "C", 0, 26, 0, 0, 3, 5, 34
"f:\Working\中医\中医装备代码8-20出差回\2023-12-9-SWD&XWTT\Drivers\CMSIS\DSP\DSP_Lib_TestSuite\Common\src\support_tests\fill_tests.c", "C", 0, 26, 0, 0, 6, 5, 37
"f:\Working\中医\中医装备代码8-20出差回\2023-12-9-SWD&XWTT\Drivers\CMSIS\DSP\DSP_Lib_TestSuite\Common\src\support_tests\support_test_common_data.c", "C", 0, 52, 0, 0, 18, 16, 86
"f:\Working\中医\中医装备代码8-20出差回\2023-12-9-SWD&XWTT\Drivers\CMSIS\DSP\DSP_Lib_TestSuite\Common\src\support_tests\support_test_group.c", "C", 0, 9, 0, 0, 0, 2, 11
"f:\Working\中医\中医装备代码8-20出差回\2023-12-9-SWD&XWTT\Drivers\CMSIS\DSP\DSP_Lib_TestSuite\Common\src\support_tests\x_to_y_tests.c", "C", 0, 62, 0, 0, 7, 12, 81
"f:\Working\中医\中医装备代码8-20出差回\2023-12-9-SWD&XWTT\Drivers\CMSIS\DSP\DSP_Lib_TestSuite\Common\src\transform_tests\cfft_family_tests.c", "C", 0, 101, 0, 0, 69, 14, 184
"f:\Working\中医\中医装备代码8-20出差回\2023-12-9-SWD&XWTT\Drivers\CMSIS\DSP\DSP_Lib_TestSuite\Common\src\transform_tests\cfft_tests.c", "C", 0, 117, 0, 0, 12, 16, 145
"f:\Working\中医\中医装备代码8-20出差回\2023-12-9-SWD&XWTT\Drivers\CMSIS\DSP\DSP_Lib_TestSuite\Common\src\transform_tests\dct4_tests.c", "C", 0, 166, 0, 0, 24, 8, 198
"f:\Working\中医\中医装备代码8-20出差回\2023-12-9-SWD&XWTT\Drivers\CMSIS\DSP\DSP_Lib_TestSuite\Common\src\transform_tests\rfft_fast_tests.c", "C", 0, 64, 0, 0, 7, 5, 76
"f:\Working\中医\中医装备代码8-20出差回\2023-12-9-SWD&XWTT\Drivers\CMSIS\DSP\DSP_Lib_TestSuite\Common\src\transform_tests\rfft_tests.c", "C", 0, 80, 0, 0, 10, 5, 95
"f:\Working\中医\中医装备代码8-20出差回\2023-12-9-SWD&XWTT\Drivers\CMSIS\DSP\DSP_Lib_TestSuite\Common\src\transform_tests\transform_test_group.c", "C", 0, 10, 0, 0, 0, 2, 12
"f:\Working\中医\中医装备代码8-20出差回\2023-12-9-SWD&XWTT\Drivers\CMSIS\DSP\DSP_Lib_TestSuite\Common\src\transform_tests\transform_tests_common_data.c", "C", 0, 3253, 0, 0, 38, 21, 3312
"f:\Working\中医\中医装备代码8-20出差回\2023-12-9-SWD&XWTT\Drivers\CMSIS\DSP\DSP_Lib_TestSuite\RefLibs\inc\ref.h", "C++", 1067, 0, 0, 0, 80, 250, 1397
"f:\Working\中医\中医装备代码8-20出差回\2023-12-9-SWD&XWTT\Drivers\CMSIS\DSP\DSP_Lib_TestSuite\RefLibs\src\BasicMathFunctions\abs.c", "C", 0, 45, 0, 0, 0, 9, 54
"f:\Working\中医\中医装备代码8-20出差回\2023-12-9-SWD&XWTT\Drivers\CMSIS\DSP\DSP_Lib_TestSuite\RefLibs\src\BasicMathFunctions\add.c", "C", 0, 49, 0, 0, 0, 9, 58
"f:\Working\中医\中医装备代码8-20出差回\2023-12-9-SWD&XWTT\Drivers\CMSIS\DSP\DSP_Lib_TestSuite\RefLibs\src\BasicMathFunctions\dot_prod.c", "C", 0, 57, 0, 0, 0, 9, 66
"f:\Working\中医\中医装备代码8-20出差回\2023-12-9-SWD&XWTT\Drivers\CMSIS\DSP\DSP_Lib_TestSuite\RefLibs\src\BasicMathFunctions\mult.c", "C", 0, 56, 0, 0, 0, 9, 65
"f:\Working\中医\中医装备代码8-20出差回\2023-12-9-SWD&XWTT\Drivers\CMSIS\DSP\DSP_Lib_TestSuite\RefLibs\src\BasicMathFunctions\negate.c", "C", 0, 45, 0, 0, 0, 9, 54
"f:\Working\中医\中医装备代码8-20出差回\2023-12-9-SWD&XWTT\Drivers\CMSIS\DSP\DSP_Lib_TestSuite\RefLibs\src\BasicMathFunctions\offset.c", "C", 0, 49, 0, 0, 0, 9, 58
"f:\Working\中医\中医装备代码8-20出差回\2023-12-9-SWD&XWTT\Drivers\CMSIS\DSP\DSP_Lib_TestSuite\RefLibs\src\BasicMathFunctions\scale.c", "C", 0, 61, 0, 0, 0, 9, 70
"f:\Working\中医\中医装备代码8-20出差回\2023-12-9-SWD&XWTT\Drivers\CMSIS\DSP\DSP_Lib_TestSuite\RefLibs\src\BasicMathFunctions\shift.c", "C", 0, 67, 0, 0, 0, 7, 74
"f:\Working\中医\中医装备代码8-20出差回\2023-12-9-SWD&XWTT\Drivers\CMSIS\DSP\DSP_Lib_TestSuite\RefLibs\src\BasicMathFunctions\sub.c", "C", 0, 49, 0, 0, 0, 9, 58
"f:\Working\中医\中医装备代码8-20出差回\2023-12-9-SWD&XWTT\Drivers\CMSIS\DSP\DSP_Lib_TestSuite\RefLibs\src\ComplexMathFunctions\cmplx_conj.c", "C", 0, 37, 0, 0, 0, 4, 41
"f:\Working\中医\中医装备代码8-20出差回\2023-12-9-SWD&XWTT\Drivers\CMSIS\DSP\DSP_Lib_TestSuite\RefLibs\src\ComplexMathFunctions\cmplx_dot_prod.c", "C", 0, 58, 0, 0, 2, 13, 73
"f:\Working\中医\中医装备代码8-20出差回\2023-12-9-SWD&XWTT\Drivers\CMSIS\DSP\DSP_Lib_TestSuite\RefLibs\src\ComplexMathFunctions\cmplx_mag.c", "C", 0, 43, 0, 0, 0, 7, 50
"f:\Working\中医\中医装备代码8-20出差回\2023-12-9-SWD&XWTT\Drivers\CMSIS\DSP\DSP_Lib_TestSuite\RefLibs\src\ComplexMathFunctions\cmplx_mag_squared.c", "C", 0, 40, 0, 0, 0, 7, 47
"f:\Working\中医\中医装备代码8-20出差回\2023-12-9-SWD&XWTT\Drivers\CMSIS\DSP\DSP_Lib_TestSuite\RefLibs\src\ComplexMathFunctions\cmplx_mult_cmplx.c", "C", 0, 50, 0, 0, 0, 7, 57
"f:\Working\中医\中医装备代码8-20出差回\2023-12-9-SWD&XWTT\Drivers\CMSIS\DSP\DSP_Lib_TestSuite\RefLibs\src\ComplexMathFunctions\cmplx_mult_real.c", "C", 0, 46, 0, 0, 0, 7, 53
"f:\Working\中医\中医装备代码8-20出差回\2023-12-9-SWD&XWTT\Drivers\CMSIS\DSP\DSP_Lib_TestSuite\RefLibs\src\ControllerFunctions\pid.c", "C", 0, 57, 0, 0, 16, 25, 98
"f:\Working\中医\中医装备代码8-20出差回\2023-12-9-SWD&XWTT\Drivers\CMSIS\DSP\DSP_Lib_TestSuite\RefLibs\src\ControllerFunctions\sin_cos.c", "C", 0, 17, 0, 0, 2, 3, 22
"f:\Working\中医\中医装备代码8-20出差回\2023-12-9-SWD&XWTT\Drivers\CMSIS\DSP\DSP_Lib_TestSuite\RefLibs\src\FastMathFunctions\cos.c", "C", 0, 9, 0, 0, 0, 3, 12
"f:\Working\中医\中医装备代码8-20出差回\2023-12-9-SWD&XWTT\Drivers\CMSIS\DSP\DSP_Lib_TestSuite\RefLibs\src\FastMathFunctions\sin.c", "C", 0, 9, 0, 0, 0, 3, 12
"f:\Working\中医\中医装备代码8-20出差回\2023-12-9-SWD&XWTT\Drivers\CMSIS\DSP\DSP_Lib_TestSuite\RefLibs\src\FastMathFunctions\sqrt.c", "C", 0, 11, 0, 0, 0, 5, 16
"f:\Working\中医\中医装备代码8-20出差回\2023-12-9-SWD&XWTT\Drivers\CMSIS\DSP\DSP_Lib_TestSuite\RefLibs\src\FilteringFunctions\biquad.c", "C", 0, 439, 0, 0, 136, 139, 714
"f:\Working\中医\中医装备代码8-20出差回\2023-12-9-SWD&XWTT\Drivers\CMSIS\DSP\DSP_Lib_TestSuite\RefLibs\src\FilteringFunctions\conv.c", "C", 0, 257, 0, 0, 48, 46, 351
"f:\Working\中医\中医装备代码8-20出差回\2023-12-9-SWD&XWTT\Drivers\CMSIS\DSP\DSP_Lib_TestSuite\RefLibs\src\FilteringFunctions\correlate.c", "C", 0, 317, 0, 0, 114, 83, 514
"f:\Working\中医\中医装备代码8-20出差回\2023-12-9-SWD&XWTT\Drivers\CMSIS\DSP\DSP_Lib_TestSuite\RefLibs\src\FilteringFunctions\fir.c", "C", 0, 187, 0, 0, 72, 67, 326
"f:\Working\中医\中医装备代码8-20出差回\2023-12-9-SWD&XWTT\Drivers\CMSIS\DSP\DSP_Lib_TestSuite\RefLibs\src\FilteringFunctions\fir_decimate.c", "C", 0, 206, 0, 0, 91, 90, 387
"f:\Working\中医\中医装备代码8-20出差回\2023-12-9-SWD&XWTT\Drivers\CMSIS\DSP\DSP_Lib_TestSuite\RefLibs\src\FilteringFunctions\fir_interpolate.c", "C", 0, 142, 0, 0, 74, 76, 292
"f:\Working\中医\中医装备代码8-20出差回\2023-12-9-SWD&XWTT\Drivers\CMSIS\DSP\DSP_Lib_TestSuite\RefLibs\src\FilteringFunctions\fir_lattice.c", "C", 0, 122, 0, 0, 57, 63, 242
"f:\Working\中医\中医装备代码8-20出差回\2023-12-9-SWD&XWTT\Drivers\CMSIS\DSP\DSP_Lib_TestSuite\RefLibs\src\FilteringFunctions\fir_sparse.c", "C", 0, 277, 0, 0, 102, 107, 486
"f:\Working\中医\中医装备代码8-20出差回\2023-12-9-SWD&XWTT\Drivers\CMSIS\DSP\DSP_Lib_TestSuite\RefLibs\src\FilteringFunctions\iir_lattice.c", "C", 0, 157, 0, 0, 66, 49, 272
"f:\Working\中医\中医装备代码8-20出差回\2023-12-9-SWD&XWTT\Drivers\CMSIS\DSP\DSP_Lib_TestSuite\RefLibs\src\FilteringFunctions\lms.c", "C", 0, 381, 0, 0, 160, 155, 696
"f:\Working\中医\中医装备代码8-20出差回\2023-12-9-SWD&XWTT\Drivers\CMSIS\DSP\DSP_Lib_TestSuite\RefLibs\src\HelperFunctions\mat_helper.c", "C", 0, 159, 0, 0, 0, 35, 194
"f:\Working\中医\中医装备代码8-20出差回\2023-12-9-SWD&XWTT\Drivers\CMSIS\DSP\DSP_Lib_TestSuite\RefLibs\src\HelperFunctions\ref_helper.c", "C", 0, 89, 0, 0, 0, 15, 104
"f:\Working\中医\中医装备代码8-20出差回\2023-12-9-SWD&XWTT\Drivers\CMSIS\DSP\DSP_Lib_TestSuite\RefLibs\src\Intrinsics\intrinsics.c", "C", 0, 167, 0, 0, 8, 64, 239
"f:\Working\中医\中医装备代码8-20出差回\2023-12-9-SWD&XWTT\Drivers\CMSIS\DSP\DSP_Lib_TestSuite\RefLibs\src\MatrixFunctions\mat_add.c", "C", 0, 43, 0, 0, 3, 13, 59
"f:\Working\中医\中医装备代码8-20出差回\2023-12-9-SWD&XWTT\Drivers\CMSIS\DSP\DSP_Lib_TestSuite\RefLibs\src\MatrixFunctions\mat_cmplx_mult.c", "C", 0, 97, 0, 0, 0, 22, 119
"f:\Working\中医\中医装备代码8-20出差回\2023-12-9-SWD&XWTT\Drivers\CMSIS\DSP\DSP_Lib_TestSuite\RefLibs\src\MatrixFunctions\mat_inverse.c", "C", 0, 41, 0, 0, 0, 17, 58
"f:\Working\中医\中医装备代码8-20出差回\2023-12-9-SWD&XWTT\Drivers\CMSIS\DSP\DSP_Lib_TestSuite\RefLibs\src\MatrixFunctions\mat_mult.c", "C", 0, 73, 0, 0, 0, 19, 92
"f:\Working\中医\中医装备代码8-20出差回\2023-12-9-SWD&XWTT\Drivers\CMSIS\DSP\DSP_Lib_TestSuite\RefLibs\src\MatrixFunctions\mat_scale.c", "C", 0, 49, 0, 0, 3, 13, 65
"f:\Working\中医\中医装备代码8-20出差回\2023-12-9-SWD&XWTT\Drivers\CMSIS\DSP\DSP_Lib_TestSuite\RefLibs\src\MatrixFunctions\mat_sub.c", "C", 0, 43, 0, 0, 3, 13, 59
"f:\Working\中医\中医装备代码8-20出差回\2023-12-9-SWD&XWTT\Drivers\CMSIS\DSP\DSP_Lib_TestSuite\RefLibs\src\MatrixFunctions\mat_trans.c", "C", 0, 65, 0, 0, 0, 13, 78
"f:\Working\中医\中医装备代码8-20出差回\2023-12-9-SWD&XWTT\Drivers\CMSIS\DSP\DSP_Lib_TestSuite\RefLibs\src\StatisticsFunctions\max.c", "C", 0, 77, 0, 0, 0, 9, 86
"f:\Working\中医\中医装备代码8-20出差回\2023-12-9-SWD&XWTT\Drivers\CMSIS\DSP\DSP_Lib_TestSuite\RefLibs\src\StatisticsFunctions\mean.c", "C", 0, 53, 0, 0, 0, 9, 62
"f:\Working\中医\中医装备代码8-20出差回\2023-12-9-SWD&XWTT\Drivers\CMSIS\DSP\DSP_Lib_TestSuite\RefLibs\src\StatisticsFunctions\min.c", "C", 0, 77, 0, 0, 0, 9, 86
"f:\Working\中医\中医装备代码8-20出差回\2023-12-9-SWD&XWTT\Drivers\CMSIS\DSP\DSP_Lib_TestSuite\RefLibs\src\StatisticsFunctions\power.c", "C", 0, 53, 0, 0, 0, 9, 62
"f:\Working\中医\中医装备代码8-20出差回\2023-12-9-SWD&XWTT\Drivers\CMSIS\DSP\DSP_Lib_TestSuite\RefLibs\src\StatisticsFunctions\rms.c", "C", 0, 53, 0, 0, 3, 10, 66
"f:\Working\中医\中医装备代码8-20出差回\2023-12-9-SWD&XWTT\Drivers\CMSIS\DSP\DSP_Lib_TestSuite\RefLibs\src\StatisticsFunctions\std.c", "C", 0, 65, 0, 0, 0, 10, 75
"f:\Working\中医\中医装备代码8-20出差回\2023-12-9-SWD&XWTT\Drivers\CMSIS\DSP\DSP_Lib_TestSuite\RefLibs\src\StatisticsFunctions\var.c", "C", 0, 61, 0, 0, 0, 10, 71
"f:\Working\中医\中医装备代码8-20出差回\2023-12-9-SWD&XWTT\Drivers\CMSIS\DSP\DSP_Lib_TestSuite\RefLibs\src\SupportFunctions\copy.c", "C", 0, 45, 0, 0, 0, 9, 54
"f:\Working\中医\中医装备代码8-20出差回\2023-12-9-SWD&XWTT\Drivers\CMSIS\DSP\DSP_Lib_TestSuite\RefLibs\src\SupportFunctions\fill.c", "C", 0, 45, 0, 0, 0, 9, 54
"f:\Working\中医\中医装备代码8-20出差回\2023-12-9-SWD&XWTT\Drivers\CMSIS\DSP\DSP_Lib_TestSuite\RefLibs\src\SupportFunctions\fixed_to_fixed.c", "C", 0, 67, 0, 0, 0, 13, 80
"f:\Working\中医\中医装备代码8-20出差回\2023-12-9-SWD&XWTT\Drivers\CMSIS\DSP\DSP_Lib_TestSuite\RefLibs\src\SupportFunctions\fixed_to_float.c", "C", 0, 45, 0, 0, 0, 9, 54
"f:\Working\中医\中医装备代码8-20出差回\2023-12-9-SWD&XWTT\Drivers\CMSIS\DSP\DSP_Lib_TestSuite\RefLibs\src\SupportFunctions\float_to_fixed.c", "C", 0, 46, 0, 0, 0, 7, 53
"f:\Working\中医\中医装备代码8-20出差回\2023-12-9-SWD&XWTT\Drivers\CMSIS\DSP\DSP_Lib_TestSuite\RefLibs\src\TransformFunctions\bitreversal.c", "C", 0, 17, 0, 0, 8, 6, 31
"f:\Working\中医\中医装备代码8-20出差回\2023-12-9-SWD&XWTT\Drivers\CMSIS\DSP\DSP_Lib_TestSuite\RefLibs\src\TransformFunctions\cfft.c", "C", 0, 478, 0, 0, 23, 98, 599
"f:\Working\中医\中医装备代码8-20出差回\2023-12-9-SWD&XWTT\Drivers\CMSIS\DSP\DSP_Lib_TestSuite\RefLibs\src\TransformFunctions\dct4.c", "C", 0, 72, 0, 0, 3, 15, 90
"f:\Working\中医\中医装备代码8-20出差回\2023-12-9-SWD&XWTT\Drivers\CMSIS\DSP\DSP_Lib_TestSuite\RefLibs\src\TransformFunctions\rfft.c", "C", 0, 250, 0, 0, 9, 44, 303
"f:\Working\中医\中医装备代码8-20出差回\2023-12-9-SWD&XWTT\Drivers\CMSIS\DSP\Examples\ARM\arm_class_marks_example\arm_class_marks_example_f32.c", "C", 0, 59, 0, 0, 120, 33, 212
"f:\Working\中医\中医装备代码8-20出差回\2023-12-9-SWD&XWTT\Drivers\CMSIS\DSP\Examples\ARM\arm_convolution_example\arm_convolution_example_f32.c", "C", 0, 92, 0, 0, 127, 29, 248
"f:\Working\中医\中医装备代码8-20出差回\2023-12-9-SWD&XWTT\Drivers\CMSIS\DSP\Examples\ARM\arm_convolution_example\math_helper.c", "C", 0, 209, 0, 0, 170, 88, 467
"f:\Working\中医\中医装备代码8-20出差回\2023-12-9-SWD&XWTT\Drivers\CMSIS\DSP\Examples\ARM\arm_convolution_example\math_helper.h", "C++", 18, 0, 0, 0, 40, 6, 64
"f:\Working\中医\中医装备代码8-20出差回\2023-12-9-SWD&XWTT\Drivers\CMSIS\DSP\Examples\ARM\arm_dotproduct_example\arm_dotproduct_example_f32.c", "C", 0, 56, 0, 0, 103, 20, 179
"f:\Working\中医\中医装备代码8-20出差回\2023-12-9-SWD&XWTT\Drivers\CMSIS\DSP\Examples\ARM\arm_fft_bin_example\arm_fft_bin_data.c", "C", 0, 260, 0, 0, 42, 7, 309
"f:\Working\中医\中医装备代码8-20出差回\2023-12-9-SWD&XWTT\Drivers\CMSIS\DSP\Examples\ARM\arm_fft_bin_example\arm_fft_bin_example_f32.c", "C", 0, 27, 0, 0, 109, 23, 159
"f:\Working\中医\中医装备代码8-20出差回\2023-12-9-SWD&XWTT\Drivers\CMSIS\DSP\Examples\ARM\arm_fir_example\arm_fir_data.c", "C", 0, 87, 0, 0, 42, 6, 135
"f:\Working\中医\中医装备代码8-20出差回\2023-12-9-SWD&XWTT\Drivers\CMSIS\DSP\Examples\ARM\arm_fir_example\arm_fir_example_f32.c", "C", 0, 47, 0, 0, 154, 33, 234
"f:\Working\中医\中医装备代码8-20出差回\2023-12-9-SWD&XWTT\Drivers\CMSIS\DSP\Examples\ARM\arm_fir_example\math_helper.c", "C", 0, 209, 0, 0, 170, 88, 467
"f:\Working\中医\中医装备代码8-20出差回\2023-12-9-SWD&XWTT\Drivers\CMSIS\DSP\Examples\ARM\arm_fir_example\math_helper.h", "C++", 18, 0, 0, 0, 40, 6, 64
"f:\Working\中医\中医装备代码8-20出差回\2023-12-9-SWD&XWTT\Drivers\CMSIS\DSP\Examples\ARM\arm_graphic_equalizer_example\arm_graphic_equalizer_data.c", "C", 0, 86, 0, 0, 42, 7, 135
"f:\Working\中医\中医装备代码8-20出差回\2023-12-9-SWD&XWTT\Drivers\CMSIS\DSP\Examples\ARM\arm_graphic_equalizer_example\arm_graphic_equalizer_example_q31.c", "C", 0, 170, 0, 0, 181, 61, 412
"f:\Working\中医\中医装备代码8-20出差回\2023-12-9-SWD&XWTT\Drivers\CMSIS\DSP\Examples\ARM\arm_graphic_equalizer_example\math_helper.c", "C", 0, 209, 0, 0, 170, 88, 467
"f:\Working\中医\中医装备代码8-20出差回\2023-12-9-SWD&XWTT\Drivers\CMSIS\DSP\Examples\ARM\arm_graphic_equalizer_example\math_helper.h", "C++", 18, 0, 0, 0, 40, 6, 64
"f:\Working\中医\中医装备代码8-20出差回\2023-12-9-SWD&XWTT\Drivers\CMSIS\DSP\Examples\ARM\arm_linear_interp_example\arm_linear_interp_data.c", "C", 0, 23564, 0, 0, 46, 7, 23617
"f:\Working\中医\中医装备代码8-20出差回\2023-12-9-SWD&XWTT\Drivers\CMSIS\DSP\Examples\ARM\arm_linear_interp_example\arm_linear_interp_example_f32.c", "C", 0, 55, 0, 0, 125, 25, 205
"f:\Working\中医\中医装备代码8-20出差回\2023-12-9-SWD&XWTT\Drivers\CMSIS\DSP\Examples\ARM\arm_linear_interp_example\math_helper.c", "C", 0, 209, 0, 0, 170, 88, 467
"f:\Working\中医\中医装备代码8-20出差回\2023-12-9-SWD&XWTT\Drivers\CMSIS\DSP\Examples\ARM\arm_linear_interp_example\math_helper.h", "C++", 18, 0, 0, 0, 40, 6, 64
"f:\Working\中医\中医装备代码8-20出差回\2023-12-9-SWD&XWTT\Drivers\CMSIS\DSP\Examples\ARM\arm_matrix_example\arm_matrix_example_f32.c", "C", 0, 68, 0, 0, 128, 38, 234
"f:\Working\中医\中医装备代码8-20出差回\2023-12-9-SWD&XWTT\Drivers\CMSIS\DSP\Examples\ARM\arm_matrix_example\math_helper.c", "C", 0, 209, 0, 0, 170, 88, 467
"f:\Working\中医\中医装备代码8-20出差回\2023-12-9-SWD&XWTT\Drivers\CMSIS\DSP\Examples\ARM\arm_matrix_example\math_helper.h", "C++", 18, 0, 0, 0, 40, 6, 64
"f:\Working\中医\中医装备代码8-20出差回\2023-12-9-SWD&XWTT\Drivers\CMSIS\DSP\Examples\ARM\arm_signal_converge_example\arm_signal_converge_data.c", "C", 0, 208, 0, 0, 51, 11, 270
"f:\Working\中医\中医装备代码8-20出差回\2023-12-9-SWD&XWTT\Drivers\CMSIS\DSP\Examples\ARM\arm_signal_converge_example\arm_signal_converge_example_f32.c", "C", 0, 68, 0, 0, 148, 44, 260
"f:\Working\中医\中医装备代码8-20出差回\2023-12-9-SWD&XWTT\Drivers\CMSIS\DSP\Examples\ARM\arm_signal_converge_example\math_helper.c", "C", 0, 209, 0, 0, 170, 88, 467
"f:\Working\中医\中医装备代码8-20出差回\2023-12-9-SWD&XWTT\Drivers\CMSIS\DSP\Examples\ARM\arm_signal_converge_example\math_helper.h", "C++", 18, 0, 0, 0, 40, 6, 64
"f:\Working\中医\中医装备代码8-20出差回\2023-12-9-SWD&XWTT\Drivers\CMSIS\DSP\Examples\ARM\arm_sin_cos_example\arm_sin_cos_example_f32.c", "C", 0, 42, 0, 0, 94, 26, 162
"f:\Working\中医\中医装备代码8-20出差回\2023-12-9-SWD&XWTT\Drivers\CMSIS\DSP\Examples\ARM\arm_variance_example\arm_variance_example_f32.c", "C", 0, 48, 0, 0, 122, 35, 205
"f:\Working\中医\中医装备代码8-20出差回\2023-12-9-SWD&XWTT\Drivers\CMSIS\DSP\Include\arm_common_tables.h", "C++", 82, 0, 0, 0, 30, 10, 122
"f:\Working\中医\中医装备代码8-20出差回\2023-12-9-SWD&XWTT\Drivers\CMSIS\DSP\Include\arm_const_structs.h", "C++", 32, 0, 0, 0, 28, 7, 67
"f:\Working\中医\中医装备代码8-20出差回\2023-12-9-SWD&XWTT\Drivers\CMSIS\DSP\Include\arm_math.h", "C++", 2924, 0, 0, 0, 3199, 1035, 7158
"f:\Working\中医\中医装备代码8-20出差回\2023-12-9-SWD&XWTT\Drivers\CMSIS\DSP\Source\BasicMathFunctions\arm_abs_f32.c", "C", 0, 39, 0, 0, 83, 32, 154
"f:\Working\中医\中医装备代码8-20出差回\2023-12-9-SWD&XWTT\Drivers\CMSIS\DSP\Source\BasicMathFunctions\arm_abs_q15.c", "C", 0, 58, 0, 0, 69, 41, 168
"f:\Working\中医\中医装备代码8-20出差回\2023-12-9-SWD&XWTT\Drivers\CMSIS\DSP\Source\BasicMathFunctions\arm_abs_q31.c", "C", 0, 34, 0, 0, 63, 22, 119
"f:\Working\中医\中医装备代码8-20出差回\2023-12-9-SWD&XWTT\Drivers\CMSIS\DSP\Source\BasicMathFunctions\arm_abs_q7.c", "C", 0, 41, 0, 0, 77, 28, 146
"f:\Working\中医\中医装备代码8-20出差回\2023-12-9-SWD&XWTT\Drivers\CMSIS\DSP\Source\BasicMathFunctions\arm_add_f32.c", "C", 0, 41, 0, 0, 74, 24, 139
"f:\Working\中医\中医装备代码8-20出差回\2023-12-9-SWD&XWTT\Drivers\CMSIS\DSP\Source\BasicMathFunctions\arm_add_q15.c", "C", 0, 36, 0, 0, 67, 26, 129
"f:\Working\中医\中医装备代码8-20出差回\2023-12-9-SWD&XWTT\Drivers\CMSIS\DSP\Source\BasicMathFunctions\arm_add_q31.c", "C", 0, 43, 0, 0, 67, 27, 137
"f:\Working\中医\中医装备代码8-20出差回\2023-12-9-SWD&XWTT\Drivers\CMSIS\DSP\Source\BasicMathFunctions\arm_add_q7.c", "C", 0, 30, 0, 0, 67, 26, 123
"f:\Working\中医\中医装备代码8-20出差回\2023-12-9-SWD&XWTT\Drivers\CMSIS\DSP\Source\BasicMathFunctions\arm_dot_prod_f32.c", "C", 0, 30, 0, 0, 72, 22, 124
"f:\Working\中医\中医装备代码8-20出差回\2023-12-9-SWD&XWTT\Drivers\CMSIS\DSP\Source\BasicMathFunctions\arm_dot_prod_q15.c", "C", 0, 33, 0, 0, 71, 25, 129
"f:\Working\中医\中医装备代码8-20出差回\2023-12-9-SWD&XWTT\Drivers\CMSIS\DSP\Source\BasicMathFunctions\arm_dot_prod_q31.c", "C", 0, 40, 0, 0, 69, 23, 132
"f:\Working\中医\中医装备代码8-20出差回\2023-12-9-SWD&XWTT\Drivers\CMSIS\DSP\Source\BasicMathFunctions\arm_dot_prod_q7.c", "C", 0, 41, 0, 0, 76, 31, 148
"f:\Working\中医\中医装备代码8-20出差回\2023-12-9-SWD&XWTT\Drivers\CMSIS\DSP\Source\BasicMathFunctions\arm_mult_f32.c", "C", 0, 46, 0, 0, 87, 30, 163
"f:\Working\中医\中医装备代码8-20出差回\2023-12-9-SWD&XWTT\Drivers\CMSIS\DSP\Source\BasicMathFunctions\arm_mult_q15.c", "C", 0, 46, 0, 0, 69, 28, 143
"f:\Working\中医\中医装备代码8-20出差回\2023-12-9-SWD&XWTT\Drivers\CMSIS\DSP\Source\BasicMathFunctions\arm_mult_q31.c", "C", 0, 57, 0, 0, 67, 25, 149
"f:\Working\中医\中医装备代码8-20出差回\2023-12-9-SWD&XWTT\Drivers\CMSIS\DSP\Source\BasicMathFunctions\arm_mult_q7.c", "C", 0, 30, 0, 0, 65, 21, 116
"f:\Working\中医\中医装备代码8-20出差回\2023-12-9-SWD&XWTT\Drivers\CMSIS\DSP\Source\BasicMathFunctions\arm_negate_f32.c", "C", 0, 38, 0, 0, 73, 24, 135
"f:\Working\中医\中医装备代码8-20出差回\2023-12-9-SWD&XWTT\Drivers\CMSIS\DSP\Source\BasicMathFunctions\arm_negate_q15.c", "C", 0, 34, 0, 0, 72, 26, 132
"f:\Working\中医\中医装备代码8-20出差回\2023-12-9-SWD&XWTT\Drivers\CMSIS\DSP\Source\BasicMathFunctions\arm_negate_q31.c", "C", 0, 34, 0, 0, 63, 21, 118
"f:\Working\中医\中医装备代码8-20出差回\2023-12-9-SWD&XWTT\Drivers\CMSIS\DSP\Source\BasicMathFunctions\arm_negate_q7.c", "C", 0, 30, 0, 0, 63, 21, 114
"f:\Working\中医\中医装备代码8-20出差回\2023-12-9-SWD&XWTT\Drivers\CMSIS\DSP\Source\BasicMathFunctions\arm_offset_f32.c", "C", 0, 39, 0, 0, 84, 32, 155
"f:\Working\中医\中医装备代码8-20出差回\2023-12-9-SWD&XWTT\Drivers\CMSIS\DSP\Source\BasicMathFunctions\arm_offset_q15.c", "C", 0, 33, 0, 0, 68, 24, 125
"f:\Working\中医\中医装备代码8-20出差回\2023-12-9-SWD&XWTT\Drivers\CMSIS\DSP\Source\BasicMathFunctions\arm_offset_q31.c", "C", 0, 38, 0, 0, 67, 24, 129
"f:\Working\中医\中医装备代码8-20出差回\2023-12-9-SWD&XWTT\Drivers\CMSIS\DSP\Source\BasicMathFunctions\arm_offset_q7.c", "C", 0, 32, 0, 0, 68, 24, 124
"f:\Working\中医\中医装备代码8-20出差回\2023-12-9-SWD&XWTT\Drivers\CMSIS\DSP\Source\BasicMathFunctions\arm_scale_f32.c", "C", 0, 39, 0, 0, 93, 26, 158
"f:\Working\中医\中医装备代码8-20出差回\2023-12-9-SWD&XWTT\Drivers\CMSIS\DSP\Source\BasicMathFunctions\arm_scale_q15.c", "C", 0, 50, 0, 0, 73, 28, 151
"f:\Working\中医\中医装备代码8-20出差回\2023-12-9-SWD&XWTT\Drivers\CMSIS\DSP\Source\BasicMathFunctions\arm_scale_q31.c", "C", 0, 103, 0, 0, 80, 45, 228
"f:\Working\中医\中医装备代码8-20出差回\2023-12-9-SWD&XWTT\Drivers\CMSIS\DSP\Source\BasicMathFunctions\arm_scale_q7.c", "C", 0, 41, 0, 0, 71, 26, 138
"f:\Working\中医\中医装备代码8-20出差回\2023-12-9-SWD&XWTT\Drivers\CMSIS\DSP\Source\BasicMathFunctions\arm_shift_q15.c", "C", 0, 97, 0, 0, 87, 53, 237
"f:\Working\中医\中医装备代码8-20出差回\2023-12-9-SWD&XWTT\Drivers\CMSIS\DSP\Source\BasicMathFunctions\arm_shift_q31.c", "C", 0, 70, 0, 0, 86, 36, 192
"f:\Working\中医\中医装备代码8-20出差回\2023-12-9-SWD&XWTT\Drivers\CMSIS\DSP\Source\BasicMathFunctions\arm_shift_q7.c", "C", 0, 82, 0, 0, 92, 35, 209
"f:\Working\中医\中医装备代码8-20出差回\2023-12-9-SWD&XWTT\Drivers\CMSIS\DSP\Source\BasicMathFunctions\arm_sub_f32.c", "C", 0, 41, 0, 0, 74, 24, 139
"f:\Working\中医\中医装备代码8-20出差回\2023-12-9-SWD&XWTT\Drivers\CMSIS\DSP\Source\BasicMathFunctions\arm_sub_q15.c", "C", 0, 37, 0, 0, 67, 25, 129
"f:\Working\中医\中医装备代码8-20出差回\2023-12-9-SWD&XWTT\Drivers\CMSIS\DSP\Source\BasicMathFunctions\arm_sub_q31.c", "C", 0, 43, 0, 0, 67, 25, 135
"f:\Working\中医\中医装备代码8-20出差回\2023-12-9-SWD&XWTT\Drivers\CMSIS\DSP\Source\BasicMathFunctions\arm_sub_q7.c", "C", 0, 30, 0, 0, 67, 23, 120
"f:\Working\中医\中医装备代码8-20出差回\2023-12-9-SWD&XWTT\Drivers\CMSIS\DSP\Source\CommonTables\arm_common_tables.c", "C", 0, 21490, 0, 0, 610, 77, 22177
"f:\Working\中医\中医装备代码8-20出差回\2023-12-9-SWD&XWTT\Drivers\CMSIS\DSP\Source\CommonTables\arm_const_structs.c", "C", 0, 288, 0, 0, 35, 57, 380
"f:\Working\中医\中医装备代码8-20出差回\2023-12-9-SWD&XWTT\Drivers\CMSIS\DSP\Source\ComplexMathFunctions\arm_cmplx_conj_f32.c", "C", 0, 48, 0, 0, 93, 31, 172
"f:\Working\中医\中医装备代码8-20出差回\2023-12-9-SWD&XWTT\Drivers\CMSIS\DSP\Source\ComplexMathFunctions\arm_cmplx_conj_q15.c", "C", 0, 56, 0, 0, 65, 29, 150
"f:\Working\中医\中医装备代码8-20出差回\2023-12-9-SWD&XWTT\Drivers\CMSIS\DSP\Source\ComplexMathFunctions\arm_cmplx_conj_q31.c", "C", 0, 50, 0, 0, 85, 35, 170
"f:\Working\中医\中医装备代码8-20出差回\2023-12-9-SWD&XWTT\Drivers\CMSIS\DSP\Source\ComplexMathFunctions\arm_cmplx_dot_prod_f32.c", "C", 0, 79, 0, 0, 82, 31, 192
"f:\Working\中医\中医装备代码8-20出差回\2023-12-9-SWD&XWTT\Drivers\CMSIS\DSP\Source\ComplexMathFunctions\arm_cmplx_dot_prod_q15.c", "C", 0, 79, 0, 0, 67, 32, 178
"f:\Working\中医\中医装备代码8-20出差回\2023-12-9-SWD&XWTT\Drivers\CMSIS\DSP\Source\ComplexMathFunctions\arm_cmplx_dot_prod_q31.c", "C", 0, 79, 0, 0, 66, 31, 176
"f:\Working\中医\中医装备代码8-20出差回\2023-12-9-SWD&XWTT\Drivers\CMSIS\DSP\Source\ComplexMathFunctions\arm_cmplx_mag_f32.c", "C", 0, 44, 0, 0, 83, 27, 154
"f:\Working\中医\中医装备代码8-20出差回\2023-12-9-SWD&XWTT\Drivers\CMSIS\DSP\Source\ComplexMathFunctions\arm_cmplx_mag_q15.c", "C", 0, 49, 0, 0, 64, 29, 142
"f:\Working\中医\中医装备代码8-20出差回\2023-12-9-SWD&XWTT\Drivers\CMSIS\DSP\Source\ComplexMathFunctions\arm_cmplx_mag_q31.c", "C", 0, 66, 0, 0, 75, 33, 174
"f:\Working\中医\中医装备代码8-20出差回\2023-12-9-SWD&XWTT\Drivers\CMSIS\DSP\Source\ComplexMathFunctions\arm_cmplx_mag_squared_f32.c", "C", 0, 57, 0, 0, 105, 43, 205
"f:\Working\中医\中医装备代码8-20出差回\2023-12-9-SWD&XWTT\Drivers\CMSIS\DSP\Source\ComplexMathFunctions\arm_cmplx_mag_squared_q15.c", "C", 0, 49, 0, 0, 64, 24, 137
"f:\Working\中医\中医装备代码8-20出差回\2023-12-9-SWD&XWTT\Drivers\CMSIS\DSP\Source\ComplexMathFunctions\arm_cmplx_mag_squared_q31.c", "C", 0, 57, 0, 0, 68, 25, 150
"f:\Working\中医\中医装备代码8-20出差回\2023-12-9-SWD&XWTT\Drivers\CMSIS\DSP\Source\ComplexMathFunctions\arm_cmplx_mult_cmplx_f32.c", "C", 0, 75, 0, 0, 80, 42, 197
"f:\Working\中医\中医装备代码8-20出差回\2023-12-9-SWD&XWTT\Drivers\CMSIS\DSP\Source\ComplexMathFunctions\arm_cmplx_mult_cmplx_q15.c", "C", 0, 75, 0, 0, 77, 30, 182
"f:\Working\中医\中医装备代码8-20出差回\2023-12-9-SWD&XWTT\Drivers\CMSIS\DSP\Source\ComplexMathFunctions\arm_cmplx_mult_cmplx_q31.c", "C", 0, 163, 0, 0, 90, 62, 315
"f:\Working\中医\中医装备代码8-20出差回\2023-12-9-SWD&XWTT\Drivers\CMSIS\DSP\Source\ComplexMathFunctions\arm_cmplx_mult_real_f32.c", "C", 0, 63, 0, 0, 108, 43, 214
"f:\Working\中医\中医装备代码8-20出差回\2023-12-9-SWD&XWTT\Drivers\CMSIS\DSP\Source\ComplexMathFunctions\arm_cmplx_mult_real_q15.c", "C", 0, 81, 0, 0, 74, 37, 192
"f:\Working\中医\中医装备代码8-20出差回\2023-12-9-SWD&XWTT\Drivers\CMSIS\DSP\Source\ComplexMathFunctions\arm_cmplx_mult_real_q31.c", "C", 0, 90, 0, 0, 87, 35, 212
"f:\Working\中医\中医装备代码8-20出差回\2023-12-9-SWD&XWTT\Drivers\CMSIS\DSP\Source\ControllerFunctions\arm_pid_init_f32.c", "C", 0, 13, 0, 0, 51, 11, 75
"f:\Working\中医\中医装备代码8-20出差回\2023-12-9-SWD&XWTT\Drivers\CMSIS\DSP\Source\ControllerFunctions\arm_pid_init_q15.c", "C", 0, 29, 0, 0, 56, 26, 111
"f:\Working\中医\中医装备代码8-20出差回\2023-12-9-SWD&XWTT\Drivers\CMSIS\DSP\Source\ControllerFunctions\arm_pid_init_q31.c", "C", 0, 21, 0, 0, 55, 20, 96
"f:\Working\中医\中医装备代码8-20出差回\2023-12-9-SWD&XWTT\Drivers\CMSIS\DSP\Source\ControllerFunctions\arm_pid_reset_f32.c", "C", 0, 6, 0, 0, 42, 6, 54
"f:\Working\中医\中医装备代码8-20出差回\2023-12-9-SWD&XWTT\Drivers\CMSIS\DSP\Source\ControllerFunctions\arm_pid_reset_q15.c", "C", 0, 6, 0, 0, 42, 5, 53
"f:\Working\中医\中医装备代码8-20出差回\2023-12-9-SWD&XWTT\Drivers\CMSIS\DSP\Source\ControllerFunctions\arm_pid_reset_q31.c", "C", 0, 6, 0, 0, 42, 6, 54
"f:\Working\中医\中医装备代码8-20出差回\2023-12-9-SWD&XWTT\Drivers\CMSIS\DSP\Source\ControllerFunctions\arm_sin_cos_f32.c", "C", 0, 47, 0, 0, 76, 22, 145
"f:\Working\中医\中医装备代码8-20出差回\2023-12-9-SWD&XWTT\Drivers\CMSIS\DSP\Source\ControllerFunctions\arm_sin_cos_q31.c", "C", 0, 43, 0, 0, 53, 15, 111
"f:\Working\中医\中医装备代码8-20出差回\2023-12-9-SWD&XWTT\Drivers\CMSIS\DSP\Source\FastMathFunctions\arm_cos_f32.c", "C", 0, 25, 0, 0, 75, 16, 116
"f:\Working\中医\中医装备代码8-20出差回\2023-12-9-SWD&XWTT\Drivers\CMSIS\DSP\Source\FastMathFunctions\arm_cos_q15.c", "C", 0, 22, 0, 0, 50, 13, 85
"f:\Working\中医\中医装备代码8-20出差回\2023-12-9-SWD&XWTT\Drivers\CMSIS\DSP\Source\FastMathFunctions\arm_cos_q31.c", "C", 0, 22, 0, 0, 50, 13, 85
"f:\Working\中医\中医装备代码8-20出差回\2023-12-9-SWD&XWTT\Drivers\CMSIS\DSP\Source\FastMathFunctions\arm_sin_f32.c", "C", 0, 29, 0, 0, 76, 19, 124
"f:\Working\中医\中医装备代码8-20出差回\2023-12-9-SWD&XWTT\Drivers\CMSIS\DSP\Source\FastMathFunctions\arm_sin_q15.c", "C", 0, 17, 0, 0, 48, 12, 77
"f:\Working\中医\中医装备代码8-20出差回\2023-12-9-SWD&XWTT\Drivers\CMSIS\DSP\Source\FastMathFunctions\arm_sin_q31.c", "C", 0, 17, 0, 0, 47, 12, 76
"f:\Working\中医\中医装备代码8-20出差回\2023-12-9-SWD&XWTT\Drivers\CMSIS\DSP\Source\FastMathFunctions\arm_sqrt_q15.c", "C", 0, 68, 0, 0, 60, 17, 145
"f:\Working\中医\中医装备代码8-20出差回\2023-12-9-SWD&XWTT\Drivers\CMSIS\DSP\Source\FastMathFunctions\arm_sqrt_q31.c", "C", 0, 67, 0, 0, 60, 16, 143
"f:\Working\中医\中医装备代码8-20出差回\2023-12-9-SWD&XWTT\Drivers\CMSIS\DSP\Source\FilteringFunctions\arm_biquad_cascade_df1_32x64_init_q31.c", "C", 0, 14, 0, 0, 74, 11, 99
"f:\Working\中医\中医装备代码8-20出差回\2023-12-9-SWD&XWTT\Drivers\CMSIS\DSP\Source\FilteringFunctions\arm_biquad_cascade_df1_32x64_q31.c", "C", 0, 151, 0, 0, 297, 102, 550
"f:\Working\中医\中医装备代码8-20出差回\2023-12-9-SWD&XWTT\Drivers\CMSIS\DSP\Source\FilteringFunctions\arm_biquad_cascade_df1_f32.c", "C", 0, 101, 0, 0, 248, 64, 413
"f:\Working\中医\中医装备代码8-20出差回\2023-12-9-SWD&XWTT\Drivers\CMSIS\DSP\Source\FilteringFunctions\arm_biquad_cascade_df1_fast_q15.c", "C", 0, 86, 0, 0, 119, 69, 274
"f:\Working\中医\中医装备代码8-20出差回\2023-12-9-SWD&XWTT\Drivers\CMSIS\DSP\Source\FilteringFunctions\arm_biquad_cascade_df1_fast_q31.c", "C", 0, 94, 0, 0, 157, 42, 293
"f:\Working\中医\中医装备代码8-20出差回\2023-12-9-SWD&XWTT\Drivers\CMSIS\DSP\Source\FilteringFunctions\arm_biquad_cascade_df1_init_f32.c", "C", 0, 12, 0, 0, 76, 10, 98
"f:\Working\中医\中医装备代码8-20出差回\2023-12-9-SWD&XWTT\Drivers\CMSIS\DSP\Source\FilteringFunctions\arm_biquad_cascade_df1_init_q15.c", "C", 0, 14, 0, 0, 75, 11, 100
"f:\Working\中医\中医装备代码8-20出差回\2023-12-9-SWD&XWTT\Drivers\CMSIS\DSP\Source\FilteringFunctions\arm_biquad_cascade_df1_init_q31.c", "C", 0, 14, 0, 0, 74, 11, 99
"f:\Working\中医\中医装备代码8-20出差回\2023-12-9-SWD&XWTT\Drivers\CMSIS\DSP\Source\FilteringFunctions\arm_biquad_cascade_df1_q15.c", "C", 0, 146, 0, 0, 155, 98, 399
"f:\Working\中医\中医装备代码8-20出差回\2023-12-9-SWD&XWTT\Drivers\CMSIS\DSP\Source\FilteringFunctions\arm_biquad_cascade_df1_q31.c", "C", 0, 140, 0, 0, 170, 83, 393
"f:\Working\中医\中医装备代码8-20出差回\2023-12-9-SWD&XWTT\Drivers\CMSIS\DSP\Source\FilteringFunctions\arm_biquad_cascade_df2T_f32.c", "C", 0, 283, 0, 0, 192, 116, 591
"f:\Working\中医\中医装备代码8-20出差回\2023-12-9-SWD&XWTT\Drivers\CMSIS\DSP\Source\FilteringFunctions\arm_biquad_cascade_df2T_f64.c", "C", 0, 283, 0, 0, 192, 116, 591
"f:\Working\中医\中医装备代码8-20出差回\2023-12-9-SWD&XWTT\Drivers\CMSIS\DSP\Source\FilteringFunctions\arm_biquad_cascade_df2T_init_f32.c", "C", 0, 12, 0, 0, 68, 10, 90
"f:\Working\中医\中医装备代码8-20出差回\2023-12-9-SWD&XWTT\Drivers\CMSIS\DSP\Source\FilteringFunctions\arm_biquad_cascade_df2T_init_f64.c", "C", 0, 12, 0, 0, 68, 10, 90
"f:\Working\中医\中医装备代码8-20出差回\2023-12-9-SWD&XWTT\Drivers\CMSIS\DSP\Source\FilteringFunctions\arm_biquad_cascade_stereo_df2T_f32.c", "C", 0, 359, 0, 0, 198, 114, 671
"f:\Working\中医\中医装备代码8-20出差回\2023-12-9-SWD&XWTT\Drivers\CMSIS\DSP\Source\FilteringFunctions\arm_biquad_cascade_stereo_df2T_init_f32.c", "C", 0, 12, 0, 0, 68, 10, 90
"f:\Working\中医\中医装备代码8-20出差回\2023-12-9-SWD&XWTT\Drivers\CMSIS\DSP\Source\FilteringFunctions\arm_conv_f32.c", "C", 0, 220, 0, 0, 291, 125, 636
"f:\Working\中医\中医装备代码8-20出差回\2023-12-9-SWD&XWTT\Drivers\CMSIS\DSP\Source\FilteringFunctions\arm_conv_fast_opt_q15.c", "C", 0, 248, 0, 0, 149, 135, 532
"f:\Working\中医\中医装备代码8-20出差回\2023-12-9-SWD&XWTT\Drivers\CMSIS\DSP\Source\FilteringFunctions\arm_conv_fast_q15.c", "C", 0, 602, 0, 0, 453, 344, 1399
"f:\Working\中医\中医装备代码8-20出差回\2023-12-9-SWD&XWTT\Drivers\CMSIS\DSP\Source\FilteringFunctions\arm_conv_fast_q31.c", "C", 0, 216, 0, 0, 238, 112, 566
"f:\Working\中医\中医装备代码8-20出差回\2023-12-9-SWD&XWTT\Drivers\CMSIS\DSP\Source\FilteringFunctions\arm_conv_opt_q15.c", "C", 0, 248, 0, 0, 151, 135, 534
"f:\Working\中医\中医装备代码8-20出差回\2023-12-9-SWD&XWTT\Drivers\CMSIS\DSP\Source\FilteringFunctions\arm_conv_opt_q7.c", "C", 0, 188, 0, 0, 136, 100, 424
"f:\Working\中医\中医装备代码8-20出差回\2023-12-9-SWD&XWTT\Drivers\CMSIS\DSP\Source\FilteringFunctions\arm_conv_partial_f32.c", "C", 0, 280, 0, 0, 271, 128, 679
"f:\Working\中医\中医装备代码8-20出差回\2023-12-9-SWD&XWTT\Drivers\CMSIS\DSP\Source\FilteringFunctions\arm_conv_partial_fast_opt_q15.c", "C", 0, 363, 0, 0, 207, 187, 757
"f:\Working\中医\中医装备代码8-20出差回\2023-12-9-SWD&XWTT\Drivers\CMSIS\DSP\Source\FilteringFunctions\arm_conv_partial_fast_q15.c", "C", 0, 676, 0, 0, 462, 357, 1495
"f:\Working\中医\中医装备代码8-20出差回\2023-12-9-SWD&XWTT\Drivers\CMSIS\DSP\Source\FilteringFunctions\arm_conv_partial_fast_q31.c", "C", 0, 267, 0, 0, 236, 118, 621
"f:\Working\中医\中医装备代码8-20出差回\2023-12-9-SWD&XWTT\Drivers\CMSIS\DSP\Source\FilteringFunctions\arm_conv_partial_opt_q15.c", "C", 0, 363, 0, 0, 203, 188, 754
"f:\Working\中医\中医装备代码8-20出差回\2023-12-9-SWD&XWTT\Drivers\CMSIS\DSP\Source\FilteringFunctions\arm_conv_partial_opt_q7.c", "C", 0, 387, 0, 0, 205, 200, 792
"f:\Working\中医\中医装备代码8-20出差回\2023-12-9-SWD&XWTT\Drivers\CMSIS\DSP\Source\FilteringFunctions\arm_conv_partial_q15.c", "C", 0, 347, 0, 0, 278, 171, 796
"f:\Working\中医\中医装备代码8-20出差回\2023-12-9-SWD&XWTT\Drivers\CMSIS\DSP\Source\FilteringFunctions\arm_conv_partial_q31.c", "C", 0, 268, 0, 0, 230, 119, 617
"f:\Working\中医\中医装备代码8-20出差回\2023-12-9-SWD&XWTT\Drivers\CMSIS\DSP\Source\FilteringFunctions\arm_conv_partial_q7.c", "C", 0, 334, 0, 0, 259, 158, 751
"f:\Working\中医\中医装备代码8-20出差回\2023-12-9-SWD&XWTT\Drivers\CMSIS\DSP\Source\FilteringFunctions\arm_conv_q15.c", "C", 0, 285, 0, 0, 274, 164, 723
"f:\Working\中医\中医装备代码8-20出差回\2023-12-9-SWD&XWTT\Drivers\CMSIS\DSP\Source\FilteringFunctions\arm_conv_q31.c", "C", 0, 208, 0, 0, 235, 111, 554
"f:\Working\中医\中医装备代码8-20出差回\2023-12-9-SWD&XWTT\Drivers\CMSIS\DSP\Source\FilteringFunctions\arm_conv_q7.c", "C", 0, 273, 0, 0, 254, 152, 679
"f:\Working\中医\中医装备代码8-20出差回\2023-12-9-SWD&XWTT\Drivers\CMSIS\DSP\Source\FilteringFunctions\arm_correlate_f32.c", "C", 0, 255, 0, 0, 339, 134, 728
"f:\Working\中医\中医装备代码8-20出差回\2023-12-9-SWD&XWTT\Drivers\CMSIS\DSP\Source\FilteringFunctions\arm_correlate_fast_opt_q15.c", "C", 0, 231, 0, 0, 143, 127, 501
"f:\Working\中医\中医装备代码8-20出差回\2023-12-9-SWD&XWTT\Drivers\CMSIS\DSP\Source\FilteringFunctions\arm_correlate_fast_q15.c", "C", 0, 556, 0, 0, 437, 315, 1308
"f:\Working\中医\中医装备代码8-20出差回\2023-12-9-SWD&XWTT\Drivers\CMSIS\DSP\Source\FilteringFunctions\arm_correlate_fast_q31.c", "C", 0, 231, 0, 0, 256, 114, 601
"f:\Working\中医\中医装备代码8-20出差回\2023-12-9-SWD&XWTT\Drivers\CMSIS\DSP\Source\FilteringFunctions\arm_correlate_opt_q15.c", "C", 0, 231, 0, 0, 142, 129, 502
"f:\Working\中医\中医装备代码8-20出差回\2023-12-9-SWD&XWTT\Drivers\CMSIS\DSP\Source\FilteringFunctions\arm_correlate_opt_q7.c", "C", 0, 196, 0, 0, 153, 104, 453
"f:\Working\中医\中医装备代码8-20出差回\2023-12-9-SWD&XWTT\Drivers\CMSIS\DSP\Source\FilteringFunctions\arm_correlate_q15.c", "C", 0, 277, 0, 0, 284, 147, 708
"f:\Working\中医\中医装备代码8-20出差回\2023-12-9-SWD&XWTT\Drivers\CMSIS\DSP\Source\FilteringFunctions\arm_correlate_q31.c", "C", 0, 242, 0, 0, 284, 128, 654
"f:\Working\中医\中医装备代码8-20出差回\2023-12-9-SWD&XWTT\Drivers\CMSIS\DSP\Source\FilteringFunctions\arm_correlate_q7.c", "C", 0, 309, 0, 0, 301, 169, 779
"f:\Working\中医\中医装备代码8-20出差回\2023-12-9-SWD&XWTT\Drivers\CMSIS\DSP\Source\FilteringFunctions\arm_fir_decimate_f32.c", "C", 0, 190, 0, 0, 220, 103, 513
"f:\Working\中医\中医装备代码8-20出差回\2023-12-9-SWD&XWTT\Drivers\CMSIS\DSP\Source\FilteringFunctions\arm_fir_decimate_fast_q15.c", "C", 0, 244, 0, 0, 192, 151, 587
"f:\Working\中医\中医装备代码8-20出差回\2023-12-9-SWD&XWTT\Drivers\CMSIS\DSP\Source\FilteringFunctions\arm_fir_decimate_fast_q31.c", "C", 0, 134, 0, 0, 130, 76, 340
"f:\Working\中医\中医装备代码8-20出差回\2023-12-9-SWD&XWTT\Drivers\CMSIS\DSP\Source\FilteringFunctions\arm_fir_decimate_init_f32.c", "C", 0, 25, 0, 0, 66, 15, 106
"f:\Working\中医\中医装备代码8-20出差回\2023-12-9-SWD&XWTT\Drivers\CMSIS\DSP\Source\FilteringFunctions\arm_fir_decimate_init_q15.c", "C", 0, 25, 0, 0, 67, 16, 108
"f:\Working\中医\中医装备代码8-20出差回\2023-12-9-SWD&XWTT\Drivers\CMSIS\DSP\Source\FilteringFunctions\arm_fir_decimate_init_q31.c", "C", 0, 25, 0, 0, 66, 15, 106
"f:\Working\中医\中医装备代码8-20出差回\2023-12-9-SWD&XWTT\Drivers\CMSIS\DSP\Source\FilteringFunctions\arm_fir_decimate_q15.c", "C", 0, 294, 0, 0, 210, 181, 685
"f:\Working\中医\中医装备代码8-20出差回\2023-12-9-SWD&XWTT\Drivers\CMSIS\DSP\Source\FilteringFunctions\arm_fir_decimate_q31.c", "C", 0, 108, 0, 0, 119, 73, 300
"f:\Working\中医\中医装备代码8-20出差回\2023-12-9-SWD&XWTT\Drivers\CMSIS\DSP\Source\FilteringFunctions\arm_fir_f32.c", "C", 0, 507, 0, 0, 297, 182, 986
"f:\Working\中医\中医装备代码8-20出差回\2023-12-9-SWD&XWTT\Drivers\CMSIS\DSP\Source\FilteringFunctions\arm_fir_fast_q15.c", "C", 0, 134, 0, 0, 124, 76, 334
"f:\Working\中医\中医装备代码8-20出差回\2023-12-9-SWD&XWTT\Drivers\CMSIS\DSP\Source\FilteringFunctions\arm_fir_fast_q31.c", "C", 0, 114, 0, 0, 122, 58, 294
"f:\Working\中医\中医装备代码8-20出差回\2023-12-9-SWD&XWTT\Drivers\CMSIS\DSP\Source\FilteringFunctions\arm_fir_init_f32.c", "C", 0, 13, 0, 0, 61, 11, 85
"f:\Working\中医\中医装备代码8-20出差回\2023-12-9-SWD&XWTT\Drivers\CMSIS\DSP\Source\FilteringFunctions\arm_fir_init_q15.c", "C", 0, 32, 0, 0, 85, 26, 143
"f:\Working\中医\中医装备代码8-20出差回\2023-12-9-SWD&XWTT\Drivers\CMSIS\DSP\Source\FilteringFunctions\arm_fir_init_q31.c", "C", 0, 13, 0, 0, 61, 11, 85
"f:\Working\中医\中医装备代码8-20出差回\2023-12-9-SWD&XWTT\Drivers\CMSIS\DSP\Source\FilteringFunctions\arm_fir_init_q7.c", "C", 0, 13, 0, 0, 59, 11, 83
"f:\Working\中医\中医装备代码8-20出差回\2023-12-9-SWD&XWTT\Drivers\CMSIS\DSP\Source\FilteringFunctions\arm_fir_interpolate_f32.c", "C", 0, 208, 0, 0, 242, 120, 570
"f:\Working\中医\中医装备代码8-20出差回\2023-12-9-SWD&XWTT\Drivers\CMSIS\DSP\Source\FilteringFunctions\arm_fir_interpolate_init_f32.c", "C", 0, 27, 0, 0, 67, 16, 110
"f:\Working\中医\中医装备代码8-20出差回\2023-12-9-SWD&XWTT\Drivers\CMSIS\DSP\Source\FilteringFunctions\arm_fir_interpolate_init_q15.c", "C", 0, 26, 0, 0, 67, 16, 109
"f:\Working\中医\中医装备代码8-20出差回\2023-12-9-SWD&XWTT\Drivers\CMSIS\DSP\Source\FilteringFunctions\arm_fir_interpolate_init_q31.c", "C", 0, 26, 0, 0, 67, 17, 110
"f:\Working\中医\中医装备代码8-20出差回\2023-12-9-SWD&XWTT\Drivers\CMSIS\DSP\Source\FilteringFunctions\arm_fir_interpolate_q15.c", "C", 0, 198, 0, 0, 170, 129, 497
"f:\Working\中医\中医装备代码8-20出差回\2023-12-9-SWD&XWTT\Drivers\CMSIS\DSP\Source\FilteringFunctions\arm_fir_interpolate_q31.c", "C", 0, 193, 0, 0, 172, 128, 493
"f:\Working\中医\中医装备代码8-20出差回\2023-12-9-SWD&XWTT\Drivers\CMSIS\DSP\Source\FilteringFunctions\arm_fir_lattice_f32.c", "C", 0, 168, 0, 0, 227, 100, 495
"f:\Working\中医\中医装备代码8-20出差回\2023-12-9-SWD&XWTT\Drivers\CMSIS\DSP\Source\FilteringFunctions\arm_fir_lattice_init_f32.c", "C", 0, 12, 0, 0, 49, 11, 72
"f:\Working\中医\中医装备代码8-20出差回\2023-12-9-SWD&XWTT\Drivers\CMSIS\DSP\Source\FilteringFunctions\arm_fir_lattice_init_q15.c", "C", 0, 12, 0, 0, 49, 11, 72
"f:\Working\中医\中医装备代码8-20出差回\2023-12-9-SWD&XWTT\Drivers\CMSIS\DSP\Source\FilteringFunctions\arm_fir_lattice_init_q31.c", "C", 0, 12, 0, 0, 49, 11, 72
"f:\Working\中医\中医装备代码8-20出差回\2023-12-9-SWD&XWTT\Drivers\CMSIS\DSP\Source\FilteringFunctions\arm_fir_lattice_q15.c", "C", 0, 226, 0, 0, 160, 139, 525
"f:\Working\中医\中医装备代码8-20出差回\2023-12-9-SWD&XWTT\Drivers\CMSIS\DSP\Source\FilteringFunctions\arm_fir_lattice_q31.c", "C", 0, 132, 0, 0, 121, 89, 342
"f:\Working\中医\中医装备代码8-20出差回\2023-12-9-SWD&XWTT\Drivers\CMSIS\DSP\Source\FilteringFunctions\arm_fir_q15.c", "C", 0, 290, 0, 0, 215, 175, 680
"f:\Working\中医\中医装备代码8-20出差回\2023-12-9-SWD&XWTT\Drivers\CMSIS\DSP\Source\FilteringFunctions\arm_fir_q31.c", "C", 0, 139, 0, 0, 136, 79, 354
"f:\Working\中医\中医装备代码8-20出差回\2023-12-9-SWD&XWTT\Drivers\CMSIS\DSP\Source\FilteringFunctions\arm_fir_q7.c", "C", 0, 160, 0, 0, 139, 87, 386
"f:\Working\中医\中医装备代码8-20出差回\2023-12-9-SWD&XWTT\Drivers\CMSIS\DSP\Source\FilteringFunctions\arm_fir_sparse_f32.c", "C", 0, 160, 0, 0, 185, 89, 434
"f:\Working\中医\中医装备代码8-20出差回\2023-12-9-SWD&XWTT\Drivers\CMSIS\DSP\Source\FilteringFunctions\arm_fir_sparse_init_f32.c", "C", 0, 18, 0, 0, 64, 14, 96
"f:\Working\中医\中医装备代码8-20出差回\2023-12-9-SWD&XWTT\Drivers\CMSIS\DSP\Source\FilteringFunctions\arm_fir_sparse_init_q15.c", "C", 0, 18, 0, 0, 64, 14, 96
"f:\Working\中医\中医装备代码8-20出差回\2023-12-9-SWD&XWTT\Drivers\CMSIS\DSP\Source\FilteringFunctions\arm_fir_sparse_init_q31.c", "C", 0, 18, 0, 0, 63, 14, 95
"f:\Working\中医\中医装备代码8-20出差回\2023-12-9-SWD&XWTT\Drivers\CMSIS\DSP\Source\FilteringFunctions\arm_fir_sparse_init_q7.c", "C", 0, 18, 0, 0, 64, 14, 96
"f:\Working\中医\中医装备代码8-20出差回\2023-12-9-SWD&XWTT\Drivers\CMSIS\DSP\Source\FilteringFunctions\arm_fir_sparse_q15.c", "C", 0, 208, 0, 0, 149, 114, 471
"f:\Working\中医\中医装备代码8-20出差回\2023-12-9-SWD&XWTT\Drivers\CMSIS\DSP\Source\FilteringFunctions\arm_fir_sparse_q31.c", "C", 0, 213, 0, 0, 138, 100, 451
"f:\Working\中医\中医装备代码8-20出差回\2023-12-9-SWD&XWTT\Drivers\CMSIS\DSP\Source\FilteringFunctions\arm_fir_sparse_q7.c", "C", 0, 207, 0, 0, 158, 105, 470
"f:\Working\中医\中医装备代码8-20出差回\2023-12-9-SWD&XWTT\Drivers\CMSIS\DSP\Source\FilteringFunctions\arm_iir_lattice_f32.c", "C", 0, 151, 0, 0, 190, 95, 436
"f:\Working\中医\中医装备代码8-20出差回\2023-12-9-SWD&XWTT\Drivers\CMSIS\DSP\Source\FilteringFunctions\arm_iir_lattice_init_f32.c", "C", 0, 15, 0, 0, 52, 13, 80
"f:\Working\中医\中医装备代码8-20出差回\2023-12-9-SWD&XWTT\Drivers\CMSIS\DSP\Source\FilteringFunctions\arm_iir_lattice_init_q15.c", "C", 0, 15, 0, 0, 52, 13, 80
"f:\Working\中医\中医装备代码8-20出差回\2023-12-9-SWD&XWTT\Drivers\CMSIS\DSP\Source\FilteringFunctions\arm_iir_lattice_init_q31.c", "C", 0, 15, 0, 0, 52, 13, 80
"f:\Working\中医\中医装备代码8-20出差回\2023-12-9-SWD&XWTT\Drivers\CMSIS\DSP\Source\FilteringFunctions\arm_iir_lattice_q15.c", "C", 0, 196, 0, 0, 145, 112, 453
"f:\Working\中医\中医装备代码8-20出差回\2023-12-9-SWD&XWTT\Drivers\CMSIS\DSP\Source\FilteringFunctions\arm_iir_lattice_q31.c", "C", 0, 133, 0, 0, 139, 67, 339
"f:\Working\中医\中医装备代码8-20出差回\2023-12-9-SWD&XWTT\Drivers\CMSIS\DSP\Source\FilteringFunctions\arm_lms_f32.c", "C", 0, 129, 0, 0, 226, 76, 431
"f:\Working\中医\中医装备代码8-20出差回\2023-12-9-SWD&XWTT\Drivers\CMSIS\DSP\Source\FilteringFunctions\arm_lms_init_f32.c", "C", 0, 15, 0, 0, 58, 11, 84
"f:\Working\中医\中医装备代码8-20出差回\2023-12-9-SWD&XWTT\Drivers\CMSIS\DSP\Source\FilteringFunctions\arm_lms_init_q15.c", "C", 0, 17, 0, 0, 64, 13, 94
"f:\Working\中医\中医装备代码8-20出差回\2023-12-9-SWD&XWTT\Drivers\CMSIS\DSP\Source\FilteringFunctions\arm_lms_init_q31.c", "C", 0, 17, 0, 0, 64, 13, 94
"f:\Working\中医\中医装备代码8-20出差回\2023-12-9-SWD&XWTT\Drivers\CMSIS\DSP\Source\FilteringFunctions\arm_lms_norm_f32.c", "C", 0, 145, 0, 0, 224, 86, 455
"f:\Working\中医\中医装备代码8-20出差回\2023-12-9-SWD&XWTT\Drivers\CMSIS\DSP\Source\FilteringFunctions\arm_lms_norm_init_f32.c", "C", 0, 17, 0, 0, 63, 14, 94
"f:\Working\中医\中医装备代码8-20出差回\2023-12-9-SWD&XWTT\Drivers\CMSIS\DSP\Source\FilteringFunctions\arm_lms_norm_init_q15.c", "C", 0, 21, 0, 0, 65, 15, 101
"f:\Working\中医\中医装备代码8-20出差回\2023-12-9-SWD&XWTT\Drivers\CMSIS\DSP\Source\FilteringFunctions\arm_lms_norm_init_q31.c", "C", 0, 21, 0, 0, 64, 15, 100
"f:\Working\中医\中医装备代码8-20出差回\2023-12-9-SWD&XWTT\Drivers\CMSIS\DSP\Source\FilteringFunctions\arm_lms_norm_q15.c", "C", 0, 176, 0, 0, 148, 105, 429
"f:\Working\中医\中医装备代码8-20出差回\2023-12-9-SWD&XWTT\Drivers\CMSIS\DSP\Source\FilteringFunctions\arm_lms_norm_q31.c", "C", 0, 170, 0, 0, 154, 96, 420
"f:\Working\中医\中医装备代码8-20出差回\2023-12-9-SWD&XWTT\Drivers\CMSIS\DSP\Source\FilteringFunctions\arm_lms_q15.c", "C", 0, 149, 0, 0, 131, 89, 369
"f:\Working\中医\中医装备代码8-20出差回\2023-12-9-SWD&XWTT\Drivers\CMSIS\DSP\Source\FilteringFunctions\arm_lms_q31.c", "C", 0, 141, 0, 0, 137, 80, 358
"f:\Working\中医\中医装备代码8-20出差回\2023-12-9-SWD&XWTT\Drivers\CMSIS\DSP\Source\MatrixFunctions\arm_mat_add_f32.c", "C", 0, 64, 0, 0, 89, 44, 197
"f:\Working\中医\中医装备代码8-20出差回\2023-12-9-SWD&XWTT\Drivers\CMSIS\DSP\Source\MatrixFunctions\arm_mat_add_q15.c", "C", 0, 49, 0, 0, 74, 29, 152
"f:\Working\中医\中医装备代码8-20出差回\2023-12-9-SWD&XWTT\Drivers\CMSIS\DSP\Source\MatrixFunctions\arm_mat_add_q31.c", "C", 0, 69, 0, 0, 83, 44, 196
"f:\Working\中医\中医装备代码8-20出差回\2023-12-9-SWD&XWTT\Drivers\CMSIS\DSP\Source\MatrixFunctions\arm_mat_cmplx_mult_f32.c", "C", 0, 118, 0, 0, 88, 67, 273
"f:\Working\中医\中医装备代码8-20出差回\2023-12-9-SWD&XWTT\Drivers\CMSIS\DSP\Source\MatrixFunctions\arm_mat_cmplx_mult_q15.c", "C", 0, 191, 0, 0, 140, 83, 414
"f:\Working\中医\中医装备代码8-20出差回\2023-12-9-SWD&XWTT\Drivers\CMSIS\DSP\Source\MatrixFunctions\arm_mat_cmplx_mult_q31.c", "C", 0, 113, 0, 0, 108, 62, 283
"f:\Working\中医\中医装备代码8-20出差回\2023-12-9-SWD&XWTT\Drivers\CMSIS\DSP\Source\MatrixFunctions\arm_mat_init_f32.c", "C", 0, 11, 0, 0, 56, 10, 77
"f:\Working\中医\中医装备代码8-20出差回\2023-12-9-SWD&XWTT\Drivers\CMSIS\DSP\Source\MatrixFunctions\arm_mat_init_q15.c", "C", 0, 11, 0, 0, 48, 9, 68
"f:\Working\中医\中医装备代码8-20出差回\2023-12-9-SWD&XWTT\Drivers\CMSIS\DSP\Source\MatrixFunctions\arm_mat_init_q31.c", "C", 0, 11, 0, 0, 52, 10, 73
"f:\Working\中医\中医装备代码8-20出差回\2023-12-9-SWD&XWTT\Drivers\CMSIS\DSP\Source\MatrixFunctions\arm_mat_inverse_f32.c", "C", 0, 290, 0, 0, 286, 116, 692
"f:\Working\中医\中医装备代码8-20出差回\2023-12-9-SWD&XWTT\Drivers\CMSIS\DSP\Source\MatrixFunctions\arm_mat_inverse_f64.c", "C", 0, 290, 0, 0, 286, 116, 692
"f:\Working\中医\中医装备代码8-20出差回\2023-12-9-SWD&XWTT\Drivers\CMSIS\DSP\Source\MatrixFunctions\arm_mat_mult_f32.c", "C", 0, 114, 0, 0, 105, 56, 275
"f:\Working\中医\中医装备代码8-20出差回\2023-12-9-SWD&XWTT\Drivers\CMSIS\DSP\Source\MatrixFunctions\arm_mat_mult_fast_q15.c", "C", 0, 254, 0, 0, 147, 125, 526
"f:\Working\中医\中医装备代码8-20出差回\2023-12-9-SWD&XWTT\Drivers\CMSIS\DSP\Source\MatrixFunctions\arm_mat_mult_fast_q31.c", "C", 0, 205, 0, 0, 109, 71, 385
"f:\Working\中医\中医装备代码8-20出差回\2023-12-9-SWD&XWTT\Drivers\CMSIS\DSP\Source\MatrixFunctions\arm_mat_mult_q15.c", "C", 0, 194, 0, 0, 149, 115, 458
"f:\Working\中医\中医装备代码8-20出差回\2023-12-9-SWD&XWTT\Drivers\CMSIS\DSP\Source\MatrixFunctions\arm_mat_mult_q31.c", "C", 0, 113, 0, 0, 111, 59, 283
"f:\Working\中医\中医装备代码8-20出差回\2023-12-9-SWD&XWTT\Drivers\CMSIS\DSP\Source\MatrixFunctions\arm_mat_scale_f32.c", "C", 0, 57, 0, 0, 83, 30, 170
"f:\Working\中医\中医装备代码8-20出差回\2023-12-9-SWD&XWTT\Drivers\CMSIS\DSP\Source\MatrixFunctions\arm_mat_scale_q15.c", "C", 0, 67, 0, 0, 76, 29, 172
"f:\Working\中医\中医装备代码8-20出差回\2023-12-9-SWD&XWTT\Drivers\CMSIS\DSP\Source\MatrixFunctions\arm_mat_scale_q31.c", "C", 0, 76, 0, 0, 75, 41, 192
"f:\Working\中医\中医装备代码8-20出差回\2023-12-9-SWD&XWTT\Drivers\CMSIS\DSP\Source\MatrixFunctions\arm_mat_sub_f32.c", "C", 0, 64, 0, 0, 90, 44, 198
"f:\Working\中医\中医装备代码8-20出差回\2023-12-9-SWD&XWTT\Drivers\CMSIS\DSP\Source\MatrixFunctions\arm_mat_sub_q15.c", "C", 0, 49, 0, 0, 72, 28, 149
"f:\Working\中医\中医装备代码8-20出差回\2023-12-9-SWD&XWTT\Drivers\CMSIS\DSP\Source\MatrixFunctions\arm_mat_sub_q31.c", "C", 0, 69, 0, 0, 84, 44, 197
"f:\Working\中医\中医装备代码8-20出差回\2023-12-9-SWD&XWTT\Drivers\CMSIS\DSP\Source\MatrixFunctions\arm_mat_trans_f32.c", "C", 0, 73, 0, 0, 86, 48, 207
"f:\Working\中医\中医装备代码8-20出差回\2023-12-9-SWD&XWTT\Drivers\CMSIS\DSP\Source\MatrixFunctions\arm_mat_trans_q15.c", "C", 0, 105, 0, 0, 89, 79, 273
"f:\Working\中医\中医装备代码8-20出差回\2023-12-9-SWD&XWTT\Drivers\CMSIS\DSP\Source\MatrixFunctions\arm_mat_trans_q31.c", "C", 0, 74, 0, 0, 79, 46, 199
"f:\Working\中医\中医装备代码8-20出差回\2023-12-9-SWD&XWTT\Drivers\CMSIS\DSP\Source\StatisticsFunctions\arm_max_f32.c", "C", 0, 64, 0, 0, 77, 30, 171
"f:\Working\中医\中医装备代码8-20出差回\2023-12-9-SWD&XWTT\Drivers\CMSIS\DSP\Source\StatisticsFunctions\arm_max_q15.c", "C", 0, 64, 0, 0, 70, 29, 163
"f:\Working\中医\中医装备代码8-20出差回\2023-12-9-SWD&XWTT\Drivers\CMSIS\DSP\Source\StatisticsFunctions\arm_max_q31.c", "C", 0, 64, 0, 0, 70, 29, 163
"f:\Working\中医\中医装备代码8-20出差回\2023-12-9-SWD&XWTT\Drivers\CMSIS\DSP\Source\StatisticsFunctions\arm_max_q7.c", "C", 0, 64, 0, 0, 70, 29, 163
"f:\Working\中医\中医装备代码8-20出差回\2023-12-9-SWD&XWTT\Drivers\CMSIS\DSP\Source\StatisticsFunctions\arm_mean_f32.c", "C", 0, 34, 0, 0, 70, 22, 126
"f:\Working\中医\中医装备代码8-20出差回\2023-12-9-SWD&XWTT\Drivers\CMSIS\DSP\Source\StatisticsFunctions\arm_mean_q15.c", "C", 0, 32, 0, 0, 69, 20, 121
"f:\Working\中医\中医装备代码8-20出差回\2023-12-9-SWD&XWTT\Drivers\CMSIS\DSP\Source\StatisticsFunctions\arm_mean_q31.c", "C", 0, 34, 0, 0, 69, 21, 124
"f:\Working\中医\中医装备代码8-20出差回\2023-12-9-SWD&XWTT\Drivers\CMSIS\DSP\Source\StatisticsFunctions\arm_mean_q7.c", "C", 0, 31, 0, 0, 69, 21, 121
"f:\Working\中医\中医装备代码8-20出差回\2023-12-9-SWD&XWTT\Drivers\CMSIS\DSP\Source\StatisticsFunctions\arm_min_f32.c", "C", 0, 64, 0, 0, 77, 30, 171
"f:\Working\中医\中医装备代码8-20出差回\2023-12-9-SWD&XWTT\Drivers\CMSIS\DSP\Source\StatisticsFunctions\arm_min_q15.c", "C", 0, 64, 0, 0, 70, 30, 164
"f:\Working\中医\中医装备代码8-20出差回\2023-12-9-SWD&XWTT\Drivers\CMSIS\DSP\Source\StatisticsFunctions\arm_min_q31.c", "C", 0, 64, 0, 0, 70, 30, 164
"f:\Working\中医\中医装备代码8-20出差回\2023-12-9-SWD&XWTT\Drivers\CMSIS\DSP\Source\StatisticsFunctions\arm_min_q7.c", "C", 0, 64, 0, 0, 70, 30, 164
"f:\Working\中医\中医装备代码8-20出差回\2023-12-9-SWD&XWTT\Drivers\CMSIS\DSP\Source\StatisticsFunctions\arm_power_f32.c", "C", 0, 35, 0, 0, 72, 23, 130
"f:\Working\中医\中医装备代码8-20出差回\2023-12-9-SWD&XWTT\Drivers\CMSIS\DSP\Source\StatisticsFunctions\arm_power_q15.c", "C", 0, 40, 0, 0, 75, 24, 139
"f:\Working\中医\中医装备代码8-20出差回\2023-12-9-SWD&XWTT\Drivers\CMSIS\DSP\Source\StatisticsFunctions\arm_power_q31.c", "C", 0, 35, 0, 0, 73, 22, 130
"f:\Working\中医\中医装备代码8-20出差回\2023-12-9-SWD&XWTT\Drivers\CMSIS\DSP\Source\StatisticsFunctions\arm_power_q7.c", "C", 0, 34, 0, 0, 73, 21, 128
"f:\Working\中医\中医装备代码8-20出差回\2023-12-9-SWD&XWTT\Drivers\CMSIS\DSP\Source\StatisticsFunctions\arm_rms_f32.c", "C", 0, 35, 0, 0, 73, 20, 128
"f:\Working\中医\中医装备代码8-20出差回\2023-12-9-SWD&XWTT\Drivers\CMSIS\DSP\Source\StatisticsFunctions\arm_rms_q15.c", "C", 0, 41, 0, 0, 76, 23, 140
"f:\Working\中医\中医装备代码8-20出差回\2023-12-9-SWD&XWTT\Drivers\CMSIS\DSP\Source\StatisticsFunctions\arm_rms_q31.c", "C", 0, 37, 0, 0, 77, 24, 138
"f:\Working\中医\中医装备代码8-20出差回\2023-12-9-SWD&XWTT\Drivers\CMSIS\DSP\Source\StatisticsFunctions\arm_std_f32.c", "C", 0, 66, 0, 0, 91, 30, 187
"f:\Working\中医\中医装备代码8-20出差回\2023-12-9-SWD&XWTT\Drivers\CMSIS\DSP\Source\StatisticsFunctions\arm_std_q15.c", "C", 0, 60, 0, 0, 88, 27, 175
"f:\Working\中医\中医装备代码8-20出差回\2023-12-9-SWD&XWTT\Drivers\CMSIS\DSP\Source\StatisticsFunctions\arm_std_q31.c", "C", 0, 57, 0, 0, 88, 25, 170
"f:\Working\中医\中医装备代码8-20出差回\2023-12-9-SWD&XWTT\Drivers\CMSIS\DSP\Source\StatisticsFunctions\arm_var_f32.c", "C", 0, 70, 0, 0, 80, 32, 182
"f:\Working\中医\中医装备代码8-20出差回\2023-12-9-SWD&XWTT\Drivers\CMSIS\DSP\Source\StatisticsFunctions\arm_var_q15.c", "C", 0, 60, 0, 0, 86, 27, 173
"f:\Working\中医\中医装备代码8-20出差回\2023-12-9-SWD&XWTT\Drivers\CMSIS\DSP\Source\StatisticsFunctions\arm_var_q31.c", "C", 0, 57, 0, 0, 88, 25, 170
"f:\Working\中医\中医装备代码8-20出差回\2023-12-9-SWD&XWTT\Drivers\CMSIS\DSP\Source\SupportFunctions\arm_copy_f32.c", "C", 0, 32, 0, 0, 70, 22, 124
"f:\Working\中医\中医装备代码8-20出差回\2023-12-9-SWD&XWTT\Drivers\CMSIS\DSP\Source\SupportFunctions\arm_copy_q15.c", "C", 0, 25, 0, 0, 59, 19, 103
"f:\Working\中医\中医装备代码8-20出差回\2023-12-9-SWD&XWTT\Drivers\CMSIS\DSP\Source\SupportFunctions\arm_copy_q31.c", "C", 0, 32, 0, 0, 59, 21, 112
"f:\Working\中医\中医装备代码8-20出差回\2023-12-9-SWD&XWTT\Drivers\CMSIS\DSP\Source\SupportFunctions\arm_copy_q7.c", "C", 0, 24, 0, 0, 60, 20, 104
"f:\Working\中医\中医装备代码8-20出差回\2023-12-9-SWD&XWTT\Drivers\CMSIS\DSP\Source\SupportFunctions\arm_fill_f32.c", "C", 0, 31, 0, 0, 70, 22, 123
"f:\Working\中医\中医装备代码8-20出差回\2023-12-9-SWD&XWTT\Drivers\CMSIS\DSP\Source\SupportFunctions\arm_fill_q15.c", "C", 0, 27, 0, 0, 60, 22, 109
"f:\Working\中医\中医装备代码8-20出差回\2023-12-9-SWD&XWTT\Drivers\CMSIS\DSP\Source\SupportFunctions\arm_fill_q31.c", "C", 0, 31, 0, 0, 59, 20, 110
"f:\Working\中医\中医装备代码8-20出差回\2023-12-9-SWD&XWTT\Drivers\CMSIS\DSP\Source\SupportFunctions\arm_fill_q7.c", "C", 0, 26, 0, 0, 60, 21, 107
"f:\Working\中医\中医装备代码8-20出差回\2023-12-9-SWD&XWTT\Drivers\CMSIS\DSP\Source\SupportFunctions\arm_float_to_q15.c", "C", 0, 69, 0, 0, 82, 42, 193
"f:\Working\中医\中医装备代码8-20出差回\2023-12-9-SWD&XWTT\Drivers\CMSIS\DSP\Source\SupportFunctions\arm_float_to_q31.c", "C", 0, 69, 0, 0, 85, 46, 200
"f:\Working\中医\中医装备代码8-20出差回\2023-12-9-SWD&XWTT\Drivers\CMSIS\DSP\Source\SupportFunctions\arm_float_to_q7.c", "C", 0, 69, 0, 0, 81, 42, 192
"f:\Working\中医\中医装备代码8-20出差回\2023-12-9-SWD&XWTT\Drivers\CMSIS\DSP\Source\SupportFunctions\arm_q15_to_float.c", "C", 0, 28, 0, 0, 70, 25, 123
"f:\Working\中医\中医装备代码8-20出差回\2023-12-9-SWD&XWTT\Drivers\CMSIS\DSP\Source\SupportFunctions\arm_q15_to_q31.c", "C", 0, 43, 0, 0, 75, 27, 145
"f:\Working\中医\中医装备代码8-20出差回\2023-12-9-SWD&XWTT\Drivers\CMSIS\DSP\Source\SupportFunctions\arm_q15_to_q7.c", "C", 0, 40, 0, 0, 72, 31, 143
"f:\Working\中医\中医装备代码8-20出差回\2023-12-9-SWD&XWTT\Drivers\CMSIS\DSP\Source\SupportFunctions\arm_q31_to_float.c", "C", 0, 28, 0, 0, 70, 22, 120
"f:\Working\中医\中医装备代码8-20出差回\2023-12-9-SWD&XWTT\Drivers\CMSIS\DSP\Source\SupportFunctions\arm_q31_to_q15.c", "C", 0, 39, 0, 0, 68, 27, 134
"f:\Working\中医\中医装备代码8-20出差回\2023-12-9-SWD&XWTT\Drivers\CMSIS\DSP\Source\SupportFunctions\arm_q31_to_q7.c", "C", 0, 35, 0, 0, 67, 23, 125
"f:\Working\中医\中医装备代码8-20出差回\2023-12-9-SWD&XWTT\Drivers\CMSIS\DSP\Source\SupportFunctions\arm_q7_to_float.c", "C", 0, 28, 0, 0, 70, 22, 120
"f:\Working\中医\中医装备代码8-20出差回\2023-12-9-SWD&XWTT\Drivers\CMSIS\DSP\Source\SupportFunctions\arm_q7_to_q15.c", "C", 0, 43, 0, 0, 69, 34, 146
"f:\Working\中医\中医装备代码8-20出差回\2023-12-9-SWD&XWTT\Drivers\CMSIS\DSP\Source\SupportFunctions\arm_q7_to_q31.c", "C", 0, 37, 0, 0, 67, 27, 131
"f:\Working\中医\中医装备代码8-20出差回\2023-12-9-SWD&XWTT\Drivers\CMSIS\DSP\Source\TransformFunctions\arm_bitreversal.c", "C", 0, 112, 0, 0, 81, 38, 231
"f:\Working\中医\中医装备代码8-20出差回\2023-12-9-SWD&XWTT\Drivers\CMSIS\DSP\Source\TransformFunctions\arm_cfft_f32.c", "C", 0, 298, 0, 0, 255, 68, 621
"f:\Working\中医\中医装备代码8-20出差回\2023-12-9-SWD&XWTT\Drivers\CMSIS\DSP\Source\TransformFunctions\arm_cfft_q15.c", "C", 0, 229, 0, 0, 50, 67, 346
"f:\Working\中医\中医装备代码8-20出差回\2023-12-9-SWD&XWTT\Drivers\CMSIS\DSP\Source\TransformFunctions\arm_cfft_q31.c", "C", 0, 163, 0, 0, 50, 40, 253
"f:\Working\中医\中医装备代码8-20出差回\2023-12-9-SWD&XWTT\Drivers\CMSIS\DSP\Source\TransformFunctions\arm_cfft_radix2_f32.c", "C", 0, 291, 0, 0, 82, 100, 473
"f:\Working\中医\中医装备代码8-20出差回\2023-12-9-SWD&XWTT\Drivers\CMSIS\DSP\Source\TransformFunctions\arm_cfft_radix2_init_f32.c", "C", 0, 75, 0, 0, 91, 27, 193
"f:\Working\中医\中医装备代码8-20出差回\2023-12-9-SWD&XWTT\Drivers\CMSIS\DSP\Source\TransformFunctions\arm_cfft_radix2_init_q15.c", "C", 0, 66, 0, 0, 80, 32, 178
"f:\Working\中医\中医装备代码8-20出差回\2023-12-9-SWD&XWTT\Drivers\CMSIS\DSP\Source\TransformFunctions\arm_cfft_radix2_init_q31.c", "C", 0, 66, 0, 0, 87, 22, 175
"f:\Working\中医\中医装备代码8-20出差回\2023-12-9-SWD&XWTT\Drivers\CMSIS\DSP\Source\TransformFunctions\arm_cfft_radix2_q15.c", "C", 0, 427, 0, 0, 75, 228, 730
"f:\Working\中医\中医装备代码8-20出差回\2023-12-9-SWD&XWTT\Drivers\CMSIS\DSP\Source\TransformFunctions\arm_cfft_radix2_q31.c", "C", 0, 206, 0, 0, 57, 76, 339
"f:\Working\中医\中医装备代码8-20出差回\2023-12-9-SWD&XWTT\Drivers\CMSIS\DSP\Source\TransformFunctions\arm_cfft_radix4_f32.c", "C", 0, 598, 0, 0, 369, 243, 1210
"f:\Working\中医\中医装备代码8-20出差回\2023-12-9-SWD&XWTT\Drivers\CMSIS\DSP\Source\TransformFunctions\arm_cfft_radix4_init_f32.c", "C", 0, 51, 0, 0, 79, 23, 153
"f:\Working\中医\中医装备代码8-20出差回\2023-12-9-SWD&XWTT\Drivers\CMSIS\DSP\Source\TransformFunctions\arm_cfft_radix4_init_q15.c", "C", 0, 46, 0, 0, 73, 22, 141
"f:\Working\中医\中医装备代码8-20出差回\2023-12-9-SWD&XWTT\Drivers\CMSIS\DSP\Source\TransformFunctions\arm_cfft_radix4_init_q31.c", "C", 0, 46, 0, 0, 77, 14, 137
"f:\Working\中医\中医装备代码8-20出差回\2023-12-9-SWD&XWTT\Drivers\CMSIS\DSP\Source\TransformFunctions\arm_cfft_radix4_q15.c", "C", 0, 749, 0, 0, 701, 461, 1911
"f:\Working\中医\中医装备代码8-20出差回\2023-12-9-SWD&XWTT\Drivers\CMSIS\DSP\Source\TransformFunctions\arm_cfft_radix4_q31.c", "C", 0, 617, 0, 0, 466, 307, 1390
"f:\Working\中医\中医装备代码8-20出差回\2023-12-9-SWD&XWTT\Drivers\CMSIS\DSP\Source\TransformFunctions\arm_cfft_radix8_f32.c", "C", 0, 226, 0, 0, 40, 20, 286
"f:\Working\中医\中医装备代码8-20出差回\2023-12-9-SWD&XWTT\Drivers\CMSIS\DSP\Source\TransformFunctions\arm_dct4_f32.c", "C", 0, 128, 0, 0, 237, 85, 450
"f:\Working\中医\中医装备代码8-20出差回\2023-12-9-SWD&XWTT\Drivers\CMSIS\DSP\Source\TransformFunctions\arm_dct4_init_f32.c", "C", 0, 16383, 0, 0, 102, 29, 16514
"f:\Working\中医\中医装备代码8-20出差回\2023-12-9-SWD&XWTT\Drivers\CMSIS\DSP\Source\TransformFunctions\arm_dct4_init_q15.c", "C", 0, 4142, 0, 0, 107, 32, 4281
"f:\Working\中医\中医装备代码8-20出差回\2023-12-9-SWD&XWTT\Drivers\CMSIS\DSP\Source\TransformFunctions\arm_dct4_init_q31.c", "C", 0, 7549, 0, 0, 106, 32, 7687
"f:\Working\中医\中医装备代码8-20出差回\2023-12-9-SWD&XWTT\Drivers\CMSIS\DSP\Source\TransformFunctions\arm_dct4_q15.c", "C", 0, 130, 0, 0, 169, 84, 383
"f:\Working\中医\中医装备代码8-20出差回\2023-12-9-SWD&XWTT\Drivers\CMSIS\DSP\Source\TransformFunctions\arm_dct4_q31.c", "C", 0, 130, 0, 0, 170, 84, 384
"f:\Working\中医\中医装备代码8-20出差回\2023-12-9-SWD&XWTT\Drivers\CMSIS\DSP\Source\TransformFunctions\arm_rfft_f32.c", "C", 0, 139, 0, 0, 118, 62, 319
"f:\Working\中医\中医装备代码8-20出差回\2023-12-9-SWD&XWTT\Drivers\CMSIS\DSP\Source\TransformFunctions\arm_rfft_fast_f32.c", "C", 0, 105, 0, 0, 172, 41, 318
"f:\Working\中医\中医装备代码8-20出差回\2023-12-9-SWD&XWTT\Drivers\CMSIS\DSP\Source\TransformFunctions\arm_rfft_fast_init_f32.c", "C", 0, 67, 0, 0, 57, 8, 132
"f:\Working\中医\中医装备代码8-20出差回\2023-12-9-SWD&XWTT\Drivers\CMSIS\DSP\Source\TransformFunctions\arm_rfft_init_f32.c", "C", 0, 4144, 0, 0, 104, 26, 4274
"f:\Working\中医\中医装备代码8-20出差回\2023-12-9-SWD&XWTT\Drivers\CMSIS\DSP\Source\TransformFunctions\arm_rfft_init_q15.c", "C", 0, 2111, 0, 0, 102, 17, 2230
"f:\Working\中医\中医装备代码8-20出差回\2023-12-9-SWD&XWTT\Drivers\CMSIS\DSP\Source\TransformFunctions\arm_rfft_init_q31.c", "C", 0, 4159, 0, 0, 102, 20, 4281
"f:\Working\中医\中医装备代码8-20出差回\2023-12-9-SWD&XWTT\Drivers\CMSIS\DSP\Source\TransformFunctions\arm_rfft_q15.c", "C", 0, 181, 0, 0, 153, 93, 427
"f:\Working\中医\中医装备代码8-20出差回\2023-12-9-SWD&XWTT\Drivers\CMSIS\DSP\Source\TransformFunctions\arm_rfft_q31.c", "C", 0, 117, 0, 0, 121, 46, 284
"f:\Working\中医\中医装备代码8-20出差回\2023-12-9-SWD&XWTT\Drivers\CMSIS\Device\ST\STM32H7xx\Include\stm32h742xx.h", "C++", 22140, 0, 0, 0, 1588, 1796, 25524
"f:\Working\中医\中医装备代码8-20出差回\2023-12-9-SWD&XWTT\Drivers\CMSIS\Device\ST\STM32H7xx\Include\stm32h743xx.h", "C++", 22661, 0, 0, 0, 1646, 1867, 26174
"f:\Working\中医\中医装备代码8-20出差回\2023-12-9-SWD&XWTT\Drivers\CMSIS\Device\ST\STM32H7xx\Include\stm32h745xx.h", "C++", 23394, 0, 0, 0, 1669, 1883, 26946
"f:\Working\中医\中医装备代码8-20出差回\2023-12-9-SWD&XWTT\Drivers\CMSIS\Device\ST\STM32H7xx\Include\stm32h747xx.h", "C++", 26367, 0, 0, 0, 1752, 2000, 30119
"f:\Working\中医\中医装备代码8-20出差回\2023-12-9-SWD&XWTT\Drivers\CMSIS\Device\ST\STM32H7xx\Include\stm32h750xx.h", "C++", 22887, 0, 0, 0, 1675, 1881, 26443
"f:\Working\中医\中医装备代码8-20出差回\2023-12-9-SWD&XWTT\Drivers\CMSIS\Device\ST\STM32H7xx\Include\stm32h753xx.h", "C++", 22887, 0, 0, 0, 1675, 1881, 26443
"f:\Working\中医\中医装备代码8-20出差回\2023-12-9-SWD&XWTT\Drivers\CMSIS\Device\ST\STM32H7xx\Include\stm32h755xx.h", "C++", 23620, 0, 0, 0, 1698, 1897, 27215
"f:\Working\中医\中医装备代码8-20出差回\2023-12-9-SWD&XWTT\Drivers\CMSIS\Device\ST\STM32H7xx\Include\stm32h757xx.h", "C++", 26593, 0, 0, 0, 1781, 2014, 30388
"f:\Working\中医\中医装备代码8-20出差回\2023-12-9-SWD&XWTT\Drivers\CMSIS\Device\ST\STM32H7xx\Include\stm32h7xx.h", "C++", 82, 0, 0, 0, 83, 42, 207
"f:\Working\中医\中医装备代码8-20出差回\2023-12-9-SWD&XWTT\Drivers\CMSIS\Device\ST\STM32H7xx\Include\system_stm32h7xx.h", "C++", 14, 0, 0, 0, 72, 20, 106
"f:\Working\中医\中医装备代码8-20出差回\2023-12-9-SWD&XWTT\Drivers\CMSIS\Device\ST\STM32H7xx\Source\Templates\system_stm32h7xx.c", "C", 0, 120, 0, 0, 180, 66, 366
"f:\Working\中医\中医装备代码8-20出差回\2023-12-9-SWD&XWTT\Drivers\CMSIS\Device\ST\STM32H7xx\Source\Templates\system_stm32h7xx_dualcore_boot_cm4_cm7.c", "C", 0, 116, 0, 0, 182, 71, 369
"f:\Working\中医\中医装备代码8-20出差回\2023-12-9-SWD&XWTT\Drivers\CMSIS\Device\ST\STM32H7xx\Source\Templates\system_stm32h7xx_dualcore_bootcm4_cm7gated.c", "C", 0, 114, 0, 0, 183, 69, 366
"f:\Working\中医\中医装备代码8-20出差回\2023-12-9-SWD&XWTT\Drivers\CMSIS\Device\ST\STM32H7xx\Source\Templates\system_stm32h7xx_dualcore_bootcm7_cm4gated.c", "C", 0, 114, 0, 0, 183, 67, 364
"f:\Working\中医\中医装备代码8-20出差回\2023-12-9-SWD&XWTT\Drivers\CMSIS\Device\ST\STM32H7xx\Source\Templates\system_stm32h7xx_singlecore.c", "C", 0, 108, 0, 0, 180, 64, 352
"f:\Working\中医\中医装备代码8-20出差回\2023-12-9-SWD&XWTT\Drivers\CMSIS\Include\cmsis_armcc.h", "C++", 380, 0, 0, 0, 353, 133, 866
"f:\Working\中医\中医装备代码8-20出差回\2023-12-9-SWD&XWTT\Drivers\CMSIS\Include\cmsis_armclang.h", "C++", 940, 0, 0, 0, 585, 345, 1870
"f:\Working\中医\中医装备代码8-20出差回\2023-12-9-SWD&XWTT\Drivers\CMSIS\Include\cmsis_compiler.h", "C++", 194, 0, 0, 0, 49, 24, 267
"f:\Working\中医\中医装备代码8-20出差回\2023-12-9-SWD&XWTT\Drivers\CMSIS\Include\cmsis_gcc.h", "C++", 1117, 0, 0, 0, 603, 366, 2086
"f:\Working\中医\中医装备代码8-20出差回\2023-12-9-SWD&XWTT\Drivers\CMSIS\Include\cmsis_iccarm.h", "C++", 747, 0, 0, 0, 43, 146, 936
"f:\Working\中医\中医装备代码8-20出差回\2023-12-9-SWD&XWTT\Drivers\CMSIS\Include\cmsis_version.h", "C++", 13, 0, 0, 0, 23, 4, 40
"f:\Working\中医\中医装备代码8-20出差回\2023-12-9-SWD&XWTT\Drivers\CMSIS\Include\core_armv8mbl.h", "C++", 1030, 0, 0, 0, 526, 363, 1919
"f:\Working\中医\中医装备代码8-20出差回\2023-12-9-SWD&XWTT\Drivers\CMSIS\Include\core_armv8mml.h", "C++", 1685, 0, 0, 0, 651, 592, 2928
"f:\Working\中医\中医装备代码8-20出差回\2023-12-9-SWD&XWTT\Drivers\CMSIS\Include\core_cm0.h", "C++", 442, 0, 0, 0, 326, 182, 950
"f:\Working\中医\中医装备代码8-20出差回\2023-12-9-SWD&XWTT\Drivers\CMSIS\Include\core_cm0plus.h", "C++", 526, 0, 0, 0, 345, 213, 1084
"f:\Working\中医\中医装备代码8-20出差回\2023-12-9-SWD&XWTT\Drivers\CMSIS\Include\core_cm1.h", "C++", 452, 0, 0, 0, 337, 188, 977
"f:\Working\中医\中医装备代码8-20出差回\2023-12-9-SWD&XWTT\Drivers\CMSIS\Include\core_cm23.h", "C++", 1078, 0, 0, 0, 532, 384, 1994
"f:\Working\中医\中医装备代码8-20出差回\2023-12-9-SWD&XWTT\Drivers\CMSIS\Include\core_cm3.h", "C++", 1052, 0, 0, 0, 470, 420, 1942
"f:\Working\中医\中医装备代码8-20出差回\2023-12-9-SWD&XWTT\Drivers\CMSIS\Include\core_cm33.h", "C++", 1735, 0, 0, 0, 655, 613, 3003
"f:\Working\中医\中医装备代码8-20出差回\2023-12-9-SWD&XWTT\Drivers\CMSIS\Include\core_cm4.h", "C++", 1186, 0, 0, 0, 486, 458, 2130
"f:\Working\中医\中医装备代码8-20出差回\2023-12-9-SWD&XWTT\Drivers\CMSIS\Include\core_cm7.h", "C++", 1539, 0, 0, 0, 565, 568, 2672
"f:\Working\中医\中医装备代码8-20出差回\2023-12-9-SWD&XWTT\Drivers\CMSIS\Include\core_sc000.h", "C++", 486, 0, 0, 0, 334, 203, 1023
"f:\Working\中医\中医装备代码8-20出差回\2023-12-9-SWD&XWTT\Drivers\CMSIS\Include\core_sc300.h", "C++", 1035, 0, 0, 0, 468, 413, 1916
"f:\Working\中医\中医装备代码8-20出差回\2023-12-9-SWD&XWTT\Drivers\CMSIS\Include\mpu_armv7.h", "C++", 120, 0, 0, 0, 125, 26, 271
"f:\Working\中医\中医装备代码8-20出差回\2023-12-9-SWD&XWTT\Drivers\CMSIS\Include\mpu_armv8.h", "C++", 163, 0, 0, 0, 130, 41, 334
"f:\Working\中医\中医装备代码8-20出差回\2023-12-9-SWD&XWTT\Drivers\CMSIS\Include\tz_context.h", "C++", 19, 0, 0, 0, 40, 12, 71
"f:\Working\中医\中医装备代码8-20出差回\2023-12-9-SWD&XWTT\Drivers\CMSIS\NN\Examples\ARM\arm_nn_examples\cifar10\RTE\Compiler\EventRecorderConf.h", "C++", 4, 0, 0, 0, 30, 11, 45
"f:\Working\中医\中医装备代码8-20出差回\2023-12-9-SWD&XWTT\Drivers\CMSIS\NN\Examples\ARM\arm_nn_examples\cifar10\RTE\_ARMCM0\RTE_Components.h", "C++", 8, 0, 0, 0, 10, 7, 25
"f:\Working\中医\中医装备代码8-20出差回\2023-12-9-SWD&XWTT\Drivers\CMSIS\NN\Examples\ARM\arm_nn_examples\cifar10\RTE\_ARMCM3\RTE_Components.h", "C++", 6, 0, 0, 0, 10, 7, 23
"f:\Working\中医\中医装备代码8-20出差回\2023-12-9-SWD&XWTT\Drivers\CMSIS\NN\Examples\ARM\arm_nn_examples\cifar10\RTE\_ARMCM4_FP\RTE_Components.h", "C++", 6, 0, 0, 0, 10, 7, 23
"f:\Working\中医\中医装备代码8-20出差回\2023-12-9-SWD&XWTT\Drivers\CMSIS\NN\Examples\ARM\arm_nn_examples\cifar10\RTE\_ARMCM7_SP\RTE_Components.h", "C++", 6, 0, 0, 0, 10, 7, 23
"f:\Working\中医\中医装备代码8-20出差回\2023-12-9-SWD&XWTT\Drivers\CMSIS\NN\Examples\ARM\arm_nn_examples\cifar10\arm_nnexamples_cifar10.cpp", "C++", 70, 0, 0, 0, 96, 31, 197
"f:\Working\中医\中医装备代码8-20出差回\2023-12-9-SWD&XWTT\Drivers\CMSIS\NN\Examples\ARM\arm_nn_examples\cifar10\arm_nnexamples_cifar10_inputs.h", "C++", 1, 0, 0, 0, 2, 4, 7
"f:\Working\中医\中医装备代码8-20出差回\2023-12-9-SWD&XWTT\Drivers\CMSIS\NN\Examples\ARM\arm_nn_examples\cifar10\arm_nnexamples_cifar10_parameter.h", "C++", 37, 0, 0, 0, 0, 7, 44
"f:\Working\中医\中医装备代码8-20出差回\2023-12-9-SWD&XWTT\Drivers\CMSIS\NN\Examples\ARM\arm_nn_examples\cifar10\arm_nnexamples_cifar10_weights.h", "C++", 18, 0, 0, 0, 0, 9, 27
"f:\Working\中医\中医装备代码8-20出差回\2023-12-9-SWD&XWTT\Drivers\CMSIS\NN\Examples\ARM\arm_nn_examples\gru\RTE\Compiler\EventRecorderConf.h", "C++", 4, 0, 0, 0, 30, 11, 45
"f:\Working\中医\中医装备代码8-20出差回\2023-12-9-SWD&XWTT\Drivers\CMSIS\NN\Examples\ARM\arm_nn_examples\gru\RTE\_ARMCM0\RTE_Components.h", "C++", 8, 0, 0, 0, 10, 7, 25
"f:\Working\中医\中医装备代码8-20出差回\2023-12-9-SWD&XWTT\Drivers\CMSIS\NN\Examples\ARM\arm_nn_examples\gru\RTE\_ARMCM3\RTE_Components.h", "C++", 6, 0, 0, 0, 10, 7, 23
"f:\Working\中医\中医装备代码8-20出差回\2023-12-9-SWD&XWTT\Drivers\CMSIS\NN\Examples\ARM\arm_nn_examples\gru\RTE\_ARMCM4_FP\RTE_Components.h", "C++", 6, 0, 0, 0, 10, 7, 23
"f:\Working\中医\中医装备代码8-20出差回\2023-12-9-SWD&XWTT\Drivers\CMSIS\NN\Examples\ARM\arm_nn_examples\gru\RTE\_ARMCM7_SP\RTE_Components.h", "C++", 6, 0, 0, 0, 10, 7, 23
"f:\Working\中医\中医装备代码8-20出差回\2023-12-9-SWD&XWTT\Drivers\CMSIS\NN\Examples\ARM\arm_nn_examples\gru\arm_nnexamples_gru.cpp", "C++", 93, 0, 0, 0, 104, 25, 222
"f:\Working\中医\中医装备代码8-20出差回\2023-12-9-SWD&XWTT\Drivers\CMSIS\NN\Examples\ARM\arm_nn_examples\gru\arm_nnexamples_gru_test_data.h", "C++", 12, 0, 0, 0, 0, 12, 24
"f:\Working\中医\中医装备代码8-20出差回\2023-12-9-SWD&XWTT\Drivers\CMSIS\NN\Include\arm_nn_tables.h", "C++", 12, 0, 0, 0, 39, 9, 60
"f:\Working\中医\中医装备代码8-20出差回\2023-12-9-SWD&XWTT\Drivers\CMSIS\NN\Include\arm_nnfunctions.h", "C++", 307, 0, 0, 0, 631, 73, 1011
"f:\Working\中医\中医装备代码8-20出差回\2023-12-9-SWD&XWTT\Drivers\CMSIS\NN\Include\arm_nnsupportfunctions.h", "C++", 70, 0, 0, 0, 105, 28, 203
"f:\Working\中医\中医装备代码8-20出差回\2023-12-9-SWD&XWTT\Drivers\CMSIS\NN\NN_Lib_Tests\nn_test\RTE\_ARMCM0\RTE_Components.h", "C++", 4, 0, 0, 0, 10, 7, 21
"f:\Working\中医\中医装备代码8-20出差回\2023-12-9-SWD&XWTT\Drivers\CMSIS\NN\NN_Lib_Tests\nn_test\RTE\_ARMCM3\RTE_Components.h", "C++", 10, 0, 0, 0, 10, 7, 27
"f:\Working\中医\中医装备代码8-20出差回\2023-12-9-SWD&XWTT\Drivers\CMSIS\NN\NN_Lib_Tests\nn_test\RTE\_ARMCM4_FP\RTE_Components.h", "C++", 10, 0, 0, 0, 10, 7, 27
"f:\Working\中医\中医装备代码8-20出差回\2023-12-9-SWD&XWTT\Drivers\CMSIS\NN\NN_Lib_Tests\nn_test\RTE\_ARMCM7_SP\RTE_Components.h", "C++", 10, 0, 0, 0, 10, 7, 27
"f:\Working\中医\中医装备代码8-20出差回\2023-12-9-SWD&XWTT\Drivers\CMSIS\NN\NN_Lib_Tests\nn_test\Ref_Implementations\arm_convolve_HWC_q15_ref.c", "C", 0, 51, 0, 0, 17, 4, 72
"f:\Working\中医\中医装备代码8-20出差回\2023-12-9-SWD&XWTT\Drivers\CMSIS\NN\NN_Lib_Tests\nn_test\Ref_Implementations\arm_convolve_HWC_q15_ref_nonsquare.c", "C", 0, 60, 0, 0, 17, 7, 84
"f:\Working\中医\中医装备代码8-20出差回\2023-12-9-SWD&XWTT\Drivers\CMSIS\NN\NN_Lib_Tests\nn_test\Ref_Implementations\arm_convolve_HWC_q7_ref.c", "C", 0, 51, 0, 0, 18, 4, 73
"f:\Working\中医\中医装备代码8-20出差回\2023-12-9-SWD&XWTT\Drivers\CMSIS\NN\NN_Lib_Tests\nn_test\Ref_Implementations\arm_convolve_HWC_q7_ref_nonsquare.c", "C", 0, 57, 0, 0, 18, 4, 79
"f:\Working\中医\中医装备代码8-20出差回\2023-12-9-SWD&XWTT\Drivers\CMSIS\NN\NN_Lib_Tests\nn_test\Ref_Implementations\arm_depthwise_separable_conv_HWC_q7_ref.c", "C", 0, 50, 0, 0, 18, 3, 71
"f:\Working\中医\中医装备代码8-20出差回\2023-12-9-SWD&XWTT\Drivers\CMSIS\NN\NN_Lib_Tests\nn_test\Ref_Implementations\arm_depthwise_separable_conv_HWC_q7_ref_nonsquare.c", "C", 0, 55, 0, 0, 18, 3, 76
"f:\Working\中医\中医装备代码8-20出差回\2023-12-9-SWD&XWTT\Drivers\CMSIS\NN\NN_Lib_Tests\nn_test\Ref_Implementations\arm_fully_connected_mat_q7_vec_q15_opt_ref.c", "C", 0, 87, 0, 0, 17, 17, 121
"f:\Working\中医\中医装备代码8-20出差回\2023-12-9-SWD&XWTT\Drivers\CMSIS\NN\NN_Lib_Tests\nn_test\Ref_Implementations\arm_fully_connected_mat_q7_vec_q15_ref.c", "C", 0, 24, 0, 0, 17, 3, 44
"f:\Working\中医\中医装备代码8-20出差回\2023-12-9-SWD&XWTT\Drivers\CMSIS\NN\NN_Lib_Tests\nn_test\Ref_Implementations\arm_fully_connected_q15_opt_ref.c", "C", 0, 87, 0, 0, 17, 16, 120
"f:\Working\中医\中医装备代码8-20出差回\2023-12-9-SWD&XWTT\Drivers\CMSIS\NN\NN_Lib_Tests\nn_test\Ref_Implementations\arm_fully_connected_q15_ref.c", "C", 0, 24, 0, 0, 17, 3, 44
"f:\Working\中医\中医装备代码8-20出差回\2023-12-9-SWD&XWTT\Drivers\CMSIS\NN\NN_Lib_Tests\nn_test\Ref_Implementations\arm_fully_connected_q7_opt_ref.c", "C", 0, 101, 0, 0, 17, 21, 139
"f:\Working\中医\中医装备代码8-20出差回\2023-12-9-SWD&XWTT\Drivers\CMSIS\NN\NN_Lib_Tests\nn_test\Ref_Implementations\arm_fully_connected_q7_ref.c", "C", 0, 24, 0, 0, 17, 3, 44
"f:\Working\中医\中医装备代码8-20出差回\2023-12-9-SWD&XWTT\Drivers\CMSIS\NN\NN_Lib_Tests\nn_test\Ref_Implementations\arm_nn_mult_ref.c", "C", 0, 34, 0, 0, 17, 8, 59
"f:\Working\中医\中医装备代码8-20出差回\2023-12-9-SWD&XWTT\Drivers\CMSIS\NN\NN_Lib_Tests\nn_test\Ref_Implementations\arm_pool_ref.c", "C", 0, 74, 0, 0, 17, 6, 97
"f:\Working\中医\中医装备代码8-20出差回\2023-12-9-SWD&XWTT\Drivers\CMSIS\NN\NN_Lib_Tests\nn_test\Ref_Implementations\arm_relu_ref.c", "C", 0, 20, 0, 0, 17, 6, 43
"f:\Working\中医\中医装备代码8-20出差回\2023-12-9-SWD&XWTT\Drivers\CMSIS\NN\NN_Lib_Tests\nn_test\Ref_Implementations\fully_connected_testing_weights.h", "C++", 4, 0, 0, 0, 0, 4, 8
"f:\Working\中医\中医装备代码8-20出差回\2023-12-9-SWD&XWTT\Drivers\CMSIS\NN\NN_Lib_Tests\nn_test\Ref_Implementations\ref_functions.h", "C++", 187, 0, 0, 0, 38, 26, 251
"f:\Working\中医\中医装备代码8-20出差回\2023-12-9-SWD&XWTT\Drivers\CMSIS\NN\NN_Lib_Tests\nn_test\arm_nnexamples_nn_test.cpp", "C++", 526, 0, 0, 0, 55, 221, 802
"f:\Working\中医\中医装备代码8-20出差回\2023-12-9-SWD&XWTT\Drivers\CMSIS\NN\NN_Lib_Tests\nn_test\arm_nnexamples_nn_test.h", "C++", 59, 0, 0, 0, 0, 20, 79
"f:\Working\中医\中医装备代码8-20出差回\2023-12-9-SWD&XWTT\Drivers\CMSIS\NN\Source\ActivationFunctions\arm_nn_activations_q15.c", "C", 0, 34, 0, 0, 55, 13, 102
"f:\Working\中医\中医装备代码8-20出差回\2023-12-9-SWD&XWTT\Drivers\CMSIS\NN\Source\ActivationFunctions\arm_nn_activations_q7.c", "C", 0, 30, 0, 0, 54, 8, 92
"f:\Working\中医\中医装备代码8-20出差回\2023-12-9-SWD&XWTT\Drivers\CMSIS\NN\Source\ActivationFunctions\arm_relu_q15.c", "C", 0, 36, 0, 0, 53, 18, 107
"f:\Working\中医\中医装备代码8-20出差回\2023-12-9-SWD&XWTT\Drivers\CMSIS\NN\Source\ActivationFunctions\arm_relu_q7.c", "C", 0, 38, 0, 0, 53, 20, 111
"f:\Working\中医\中医装备代码8-20出差回\2023-12-9-SWD&XWTT\Drivers\CMSIS\NN\Source\ConvolutionFunctions\arm_convolve_1x1_HWC_q7_fast_nonsquare.c", "C", 0, 118, 0, 0, 89, 29, 236
"f:\Working\中医\中医装备代码8-20出差回\2023-12-9-SWD&XWTT\Drivers\CMSIS\NN\Source\ConvolutionFunctions\arm_convolve_HWC_q15_basic.c", "C", 0, 112, 0, 0, 76, 20, 208
"f:\Working\中医\中医装备代码8-20出差回\2023-12-9-SWD&XWTT\Drivers\CMSIS\NN\Source\ConvolutionFunctions\arm_convolve_HWC_q15_fast.c", "C", 0, 137, 0, 0, 90, 29, 256
"f:\Working\中医\中医装备代码8-20出差回\2023-12-9-SWD&XWTT\Drivers\CMSIS\NN\Source\ConvolutionFunctions\arm_convolve_HWC_q15_fast_nonsquare.c", "C", 0, 142, 0, 0, 95, 29, 266
"f:\Working\中医\中医装备代码8-20出差回\2023-12-9-SWD&XWTT\Drivers\CMSIS\NN\Source\ConvolutionFunctions\arm_convolve_HWC_q7_RGB.c", "C", 0, 137, 0, 0, 115, 28, 280
"f:\Working\中医\中医装备代码8-20出差回\2023-12-9-SWD&XWTT\Drivers\CMSIS\NN\Source\ConvolutionFunctions\arm_convolve_HWC_q7_basic.c", "C", 0, 120, 0, 0, 86, 25, 231
"f:\Working\中医\中医装备代码8-20出差回\2023-12-9-SWD&XWTT\Drivers\CMSIS\NN\Source\ConvolutionFunctions\arm_convolve_HWC_q7_basic_nonsquare.c", "C", 0, 124, 0, 0, 80, 25, 229
"f:\Working\中医\中医装备代码8-20出差回\2023-12-9-SWD&XWTT\Drivers\CMSIS\NN\Source\ConvolutionFunctions\arm_convolve_HWC_q7_fast.c", "C", 0, 248, 0, 0, 122, 39, 409
"f:\Working\中医\中医装备代码8-20出差回\2023-12-9-SWD&XWTT\Drivers\CMSIS\NN\Source\ConvolutionFunctions\arm_convolve_HWC_q7_fast_nonsquare.c", "C", 0, 236, 0, 0, 105, 39, 380
"f:\Working\中医\中医装备代码8-20出差回\2023-12-9-SWD&XWTT\Drivers\CMSIS\NN\Source\ConvolutionFunctions\arm_depthwise_separable_conv_HWC_q7.c", "C", 0, 283, 0, 0, 95, 41, 419
"f:\Working\中医\中医装备代码8-20出差回\2023-12-9-SWD&XWTT\Drivers\CMSIS\NN\Source\ConvolutionFunctions\arm_depthwise_separable_conv_HWC_q7_nonsquare.c", "C", 0, 280, 0, 0, 91, 41, 412
"f:\Working\中医\中医装备代码8-20出差回\2023-12-9-SWD&XWTT\Drivers\CMSIS\NN\Source\ConvolutionFunctions\arm_nn_mat_mult_kernel_q7_q15.c", "C", 0, 104, 0, 0, 56, 28, 188
"f:\Working\中医\中医装备代码8-20出差回\2023-12-9-SWD&XWTT\Drivers\CMSIS\NN\Source\ConvolutionFunctions\arm_nn_mat_mult_kernel_q7_q15_reordered.c", "C", 0, 68, 0, 0, 52, 19, 139
"f:\Working\中医\中医装备代码8-20出差回\2023-12-9-SWD&XWTT\Drivers\CMSIS\NN\Source\FullyConnectedFunctions\arm_fully_connected_mat_q7_vec_q15.c", "C", 0, 96, 0, 0, 68, 36, 200
"f:\Working\中医\中医装备代码8-20出差回\2023-12-9-SWD&XWTT\Drivers\CMSIS\NN\Source\FullyConnectedFunctions\arm_fully_connected_mat_q7_vec_q15_opt.c", "C", 0, 220, 0, 0, 124, 60, 404
"f:\Working\中医\中医装备代码8-20出差回\2023-12-9-SWD&XWTT\Drivers\CMSIS\NN\Source\FullyConnectedFunctions\arm_fully_connected_q15.c", "C", 0, 95, 0, 0, 65, 34, 194
"f:\Working\中医\中医装备代码8-20出差回\2023-12-9-SWD&XWTT\Drivers\CMSIS\NN\Source\FullyConnectedFunctions\arm_fully_connected_q15_opt.c", "C", 0, 177, 0, 0, 104, 52, 333
"f:\Working\中医\中医装备代码8-20出差回\2023-12-9-SWD&XWTT\Drivers\CMSIS\NN\Source\FullyConnectedFunctions\arm_fully_connected_q7.c", "C", 0, 94, 0, 0, 68, 37, 199
"f:\Working\中医\中医装备代码8-20出差回\2023-12-9-SWD&XWTT\Drivers\CMSIS\NN\Source\FullyConnectedFunctions\arm_fully_connected_q7_opt.c", "C", 0, 286, 0, 0, 136, 63, 485
"f:\Working\中医\中医装备代码8-20出差回\2023-12-9-SWD&XWTT\Drivers\CMSIS\NN\Source\NNSupportFunctions\arm_nn_mult_q15.c", "C", 0, 47, 0, 0, 71, 30, 148
"f:\Working\中医\中医装备代码8-20出差回\2023-12-9-SWD&XWTT\Drivers\CMSIS\NN\Source\NNSupportFunctions\arm_nn_mult_q7.c", "C", 0, 31, 0, 0, 67, 22, 120
"f:\Working\中医\中医装备代码8-20出差回\2023-12-9-SWD&XWTT\Drivers\CMSIS\NN\Source\NNSupportFunctions\arm_nntables.c", "C", 0, 225, 0, 0, 61, 12, 298
"f:\Working\中医\中医装备代码8-20出差回\2023-12-9-SWD&XWTT\Drivers\CMSIS\NN\Source\NNSupportFunctions\arm_q7_to_q15_no_shift.c", "C", 0, 36, 0, 0, 70, 29, 135
"f:\Working\中医\中医装备代码8-20出差回\2023-12-9-SWD&XWTT\Drivers\CMSIS\NN\Source\NNSupportFunctions\arm_q7_to_q15_reordered_no_shift.c", "C", 0, 33, 0, 0, 89, 24, 146
"f:\Working\中医\中医装备代码8-20出差回\2023-12-9-SWD&XWTT\Drivers\CMSIS\NN\Source\PoolingFunctions\arm_pool_q7_HWC.c", "C", 0, 265, 0, 0, 122, 62, 449
"f:\Working\中医\中医装备代码8-20出差回\2023-12-9-SWD&XWTT\Drivers\CMSIS\NN\Source\SoftmaxFunctions\arm_softmax_q15.c", "C", 0, 40, 0, 0, 67, 14, 121
"f:\Working\中医\中医装备代码8-20出差回\2023-12-9-SWD&XWTT\Drivers\CMSIS\NN\Source\SoftmaxFunctions\arm_softmax_q7.c", "C", 0, 38, 0, 0, 70, 14, 122
"f:\Working\中医\中医装备代码8-20出差回\2023-12-9-SWD&XWTT\Drivers\CMSIS\RTOS2\Include\cmsis_os2.h", "C++", 275, 0, 0, 0, 341, 141, 757
"f:\Working\中医\中医装备代码8-20出差回\2023-12-9-SWD&XWTT\Drivers\CMSIS\RTOS2\Include\os_tick.h", "C++", 18, 0, 0, 0, 40, 14, 72
"f:\Working\中医\中医装备代码8-20出差回\2023-12-9-SWD&XWTT\Drivers\CMSIS\RTOS2\Source\os_systick.c", "C", 0, 72, 0, 0, 35, 26, 133
"f:\Working\中医\中医装备代码8-20出差回\2023-12-9-SWD&XWTT\Drivers\CMSIS\RTOS2\Source\os_tick_gtim.c", "C", 0, 94, 0, 0, 54, 40, 188
"f:\Working\中医\中医装备代码8-20出差回\2023-12-9-SWD&XWTT\Drivers\CMSIS\RTOS2\Source\os_tick_ptim.c", "C", 0, 82, 0, 0, 48, 36, 166
"f:\Working\中医\中医装备代码8-20出差回\2023-12-9-SWD&XWTT\Drivers\CMSIS\RTOS2\Template\cmsis_os.h", "C++", 407, 0, 0, 0, 390, 126, 923
"f:\Working\中医\中医装备代码8-20出差回\2023-12-9-SWD&XWTT\Drivers\CMSIS\RTOS2\Template\cmsis_os1.c", "C", 0, 256, 0, 0, 33, 73, 362
"f:\Working\中医\中医装备代码8-20出差回\2023-12-9-SWD&XWTT\Drivers\CMSIS\RTOS\Template\cmsis_os.h", "C++", 228, 0, 0, 0, 347, 124, 699
"f:\Working\中医\中医装备代码8-20出差回\2023-12-9-SWD&XWTT\Drivers\STM32H7xx_HAL_Driver\Inc\Legacy\stm32_hal_legacy.h", "C++", 2743, 0, 0, 0, 547, 356, 3646
"f:\Working\中医\中医装备代码8-20出差回\2023-12-9-SWD&XWTT\Drivers\STM32H7xx_HAL_Driver\Inc\stm32_assert_template.h", "C++", 15, 0, 0, 0, 35, 8, 58
"f:\Working\中医\中医装备代码8-20出差回\2023-12-9-SWD&XWTT\Drivers\STM32H7xx_HAL_Driver\Inc\stm32h7xx_hal.h", "C++", 676, 0, 0, 0, 210, 122, 1008
"f:\Working\中医\中医装备代码8-20出差回\2023-12-9-SWD&XWTT\Drivers\STM32H7xx_HAL_Driver\Inc\stm32h7xx_hal_adc.h", "C++", 522, 0, 0, 0, 1117, 171, 1810
"f:\Working\中医\中医装备代码8-20出差回\2023-12-9-SWD&XWTT\Drivers\STM32H7xx_HAL_Driver\Inc\stm32h7xx_hal_adc_ex.h", "C++", 417, 0, 0, 0, 623, 133, 1173
"f:\Working\中医\中医装备代码8-20出差回\2023-12-9-SWD&XWTT\Drivers\STM32H7xx_HAL_Driver\Inc\stm32h7xx_hal_cec.h", "C++", 220, 0, 0, 0, 475, 100, 795
"f:\Working\中医\中医装备代码8-20出差回\2023-12-9-SWD&XWTT\Drivers\STM32H7xx_HAL_Driver\Inc\stm32h7xx_hal_comp.h", "C++", 248, 0, 0, 0, 539, 145, 932
"f:\Working\中医\中医装备代码8-20出差回\2023-12-9-SWD&XWTT\Drivers\STM32H7xx_HAL_Driver\Inc\stm32h7xx_hal_conf_template.h", "C++", 305, 0, 0, 0, 81, 81, 467
"f:\Working\中医\中医装备代码8-20出差回\2023-12-9-SWD&XWTT\Drivers\STM32H7xx_HAL_Driver\Inc\stm32h7xx_hal_cortex.h", "C++", 216, 0, 0, 0, 185, 61, 462
"f:\Working\中医\中医装备代码8-20出差回\2023-12-9-SWD&XWTT\Drivers\STM32H7xx_HAL_Driver\Inc\stm32h7xx_hal_crc.h", "C++", 80, 0, 0, 0, 210, 55, 345
"f:\Working\中医\中医装备代码8-20出差回\2023-12-9-SWD&XWTT\Drivers\STM32H7xx_HAL_Driver\Inc\stm32h7xx_hal_crc_ex.h", "C++", 28, 0, 0, 0, 97, 29, 154
"f:\Working\中医\中医装备代码8-20出差回\2023-12-9-SWD&XWTT\Drivers\STM32H7xx_HAL_Driver\Inc\stm32h7xx_hal_cryp.h", "C++", 167, 0, 0, 0, 253, 114, 534
"f:\Working\中医\中医装备代码8-20出差回\2023-12-9-SWD&XWTT\Drivers\STM32H7xx_HAL_Driver\Inc\stm32h7xx_hal_cryp_ex.h", "C++", 14, 0, 0, 0, 83, 27, 124
"f:\Working\中医\中医装备代码8-20出差回\2023-12-9-SWD&XWTT\Drivers\STM32H7xx_HAL_Driver\Inc\stm32h7xx_hal_dac.h", "C++", 170, 0, 0, 0, 256, 96, 522
"f:\Working\中医\中医装备代码8-20出差回\2023-12-9-SWD&XWTT\Drivers\STM32H7xx_HAL_Driver\Inc\stm32h7xx_hal_dac_ex.h", "C++", 97, 0, 0, 0, 88, 46, 231
"f:\Working\中医\中医装备代码8-20出差回\2023-12-9-SWD&XWTT\Drivers\STM32H7xx_HAL_Driver\Inc\stm32h7xx_hal_dcmi.h", "C++", 210, 0, 0, 0, 342, 112, 664
"f:\Working\中医\中医装备代码8-20出差回\2023-12-9-SWD&XWTT\Drivers\STM32H7xx_HAL_Driver\Inc\stm32h7xx_hal_def.h", "C++", 97, 0, 0, 0, 68, 25, 190
"f:\Working\中医\中医装备代码8-20出差回\2023-12-9-SWD&XWTT\Drivers\STM32H7xx_HAL_Driver\Inc\stm32h7xx_hal_dfsdm.h", "C++", 410, 0, 0, 0, 320, 74, 804
"f:\Working\中医\中医装备代码8-20出差回\2023-12-9-SWD&XWTT\Drivers\STM32H7xx_HAL_Driver\Inc\stm32h7xx_hal_dma.h", "C++", 537, 0, 0, 0, 404, 161, 1102
"f:\Working\中医\中医装备代码8-20出差回\2023-12-9-SWD&XWTT\Drivers\STM32H7xx_HAL_Driver\Inc\stm32h7xx_hal_dma2d.h", "C++", 221, 0, 0, 0, 337, 117, 675
"f:\Working\中医\中医装备代码8-20出差回\2023-12-9-SWD&XWTT\Drivers\STM32H7xx_HAL_Driver\Inc\stm32h7xx_hal_dma_ex.h", "C++", 124, 0, 0, 0, 126, 57, 307
"f:\Working\中医\中医装备代码8-20出差回\2023-12-9-SWD&XWTT\Drivers\STM32H7xx_HAL_Driver\Inc\stm32h7xx_hal_dsi.h", "C++", 551, 0, 0, 0, 611, 191, 1353
"f:\Working\中医\中医装备代码8-20出差回\2023-12-9-SWD&XWTT\Drivers\STM32H7xx_HAL_Driver\Inc\stm32h7xx_hal_eth.h", "C++", 657, 0, 0, 0, 753, 268, 1678
"f:\Working\中医\中医装备代码8-20出差回\2023-12-9-SWD&XWTT\Drivers\STM32H7xx_HAL_Driver\Inc\stm32h7xx_hal_eth_ex.h", "C++", 104, 0, 0, 0, 189, 61, 354
"f:\Working\中医\中医装备代码8-20出差回\2023-12-9-SWD&XWTT\Drivers\STM32H7xx_HAL_Driver\Inc\stm32h7xx_hal_exti.h", "C++", 239, 0, 0, 0, 159, 60, 458
"f:\Working\中医\中医装备代码8-20出差回\2023-12-9-SWD&XWTT\Drivers\STM32H7xx_HAL_Driver\Inc\stm32h7xx_hal_fdcan.h", "C++", 1084, 0, 0, 0, 1026, 305, 2415
"f:\Working\中医\中医装备代码8-20出差回\2023-12-9-SWD&XWTT\Drivers\STM32H7xx_HAL_Driver\Inc\stm32h7xx_hal_flash.h", "C++", 233, 0, 0, 0, 331, 87, 651
"f:\Working\中医\中医装备代码8-20出差回\2023-12-9-SWD&XWTT\Drivers\STM32H7xx_HAL_Driver\Inc\stm32h7xx_hal_flash_ex.h", "C++", 290, 0, 0, 0, 380, 137, 807
"f:\Working\中医\中医装备代码8-20出差回\2023-12-9-SWD&XWTT\Drivers\STM32H7xx_HAL_Driver\Inc\stm32h7xx_hal_gpio.h", "C++", 99, 0, 0, 0, 197, 51, 347
"f:\Working\中医\中医装备代码8-20出差回\2023-12-9-SWD&XWTT\Drivers\STM32H7xx_HAL_Driver\Inc\stm32h7xx_hal_gpio_ex.h", "C++", 153, 0, 0, 0, 148, 45, 346
"f:\Working\中医\中医装备代码8-20出差回\2023-12-9-SWD&XWTT\Drivers\STM32H7xx_HAL_Driver\Inc\stm32h7xx_hal_hash.h", "C++", 191, 0, 0, 0, 312, 119, 622
"f:\Working\中医\中医装备代码8-20出差回\2023-12-9-SWD&XWTT\Drivers\STM32H7xx_HAL_Driver\Inc\stm32h7xx_hal_hash_ex.h", "C++", 40, 0, 0, 0, 85, 35, 160
"f:\Working\中医\中医装备代码8-20出差回\2023-12-9-SWD&XWTT\Drivers\STM32H7xx_HAL_Driver\Inc\stm32h7xx_hal_hcd.h", "C++", 126, 0, 0, 0, 156, 48, 330
"f:\Working\中医\中医装备代码8-20出差回\2023-12-9-SWD&XWTT\Drivers\STM32H7xx_HAL_Driver\Inc\stm32h7xx_hal_hrtim.h", "C++", 1995, 0, 0, 0, 1311, 362, 3668
"f:\Working\中医\中医装备代码8-20出差回\2023-12-9-SWD&XWTT\Drivers\STM32H7xx_HAL_Driver\Inc\stm32h7xx_hal_hsem.h", "C++", 66, 0, 0, 0, 116, 33, 215
"f:\Working\中医\中医装备代码8-20出差回\2023-12-9-SWD&XWTT\Drivers\STM32H7xx_HAL_Driver\Inc\stm32h7xx_hal_i2c.h", "C++", 286, 0, 0, 0, 382, 115, 783
"f:\Working\中医\中医装备代码8-20出差回\2023-12-9-SWD&XWTT\Drivers\STM32H7xx_HAL_Driver\Inc\stm32h7xx_hal_i2c_ex.h", "C++", 60, 0, 0, 0, 91, 31, 182
"f:\Working\中医\中医装备代码8-20出差回\2023-12-9-SWD&XWTT\Drivers\STM32H7xx_HAL_Driver\Inc\stm32h7xx_hal_i2s.h", "C++", 213, 0, 0, 0, 316, 101, 630
"f:\Working\中医\中医装备代码8-20出差回\2023-12-9-SWD&XWTT\Drivers\STM32H7xx_HAL_Driver\Inc\stm32h7xx_hal_i2s_ex.h", "C++", 39, 0, 0, 0, 112, 24, 175
"f:\Working\中医\中医装备代码8-20出差回\2023-12-9-SWD&XWTT\Drivers\STM32H7xx_HAL_Driver\Inc\stm32h7xx_hal_irda.h", "C++", 278, 0, 0, 0, 479, 128, 885
"f:\Working\中医\中医装备代码8-20出差回\2023-12-9-SWD&XWTT\Drivers\STM32H7xx_HAL_Driver\Inc\stm32h7xx_hal_irda_ex.h", "C++", 559, 0, 0, 0, 71, 21, 651
"f:\Working\中医\中医装备代码8-20出差回\2023-12-9-SWD&XWTT\Drivers\STM32H7xx_HAL_Driver\Inc\stm32h7xx_hal_iwdg.h", "C++", 48, 0, 0, 0, 149, 46, 243
"f:\Working\中医\中医装备代码8-20出差回\2023-12-9-SWD&XWTT\Drivers\STM32H7xx_HAL_Driver\Inc\stm32h7xx_hal_jpeg.h", "C++", 199, 0, 0, 0, 330, 127, 656
"f:\Working\中医\中医装备代码8-20出差回\2023-12-9-SWD&XWTT\Drivers\STM32H7xx_HAL_Driver\Inc\stm32h7xx_hal_lptim.h", "C++", 278, 0, 0, 0, 378, 120, 776
"f:\Working\中医\中医装备代码8-20出差回\2023-12-9-SWD&XWTT\Drivers\STM32H7xx_HAL_Driver\Inc\stm32h7xx_hal_ltdc.h", "C++", 237, 0, 0, 0, 346, 106, 689
"f:\Working\中医\中医装备代码8-20出差回\2023-12-9-SWD&XWTT\Drivers\STM32H7xx_HAL_Driver\Inc\stm32h7xx_hal_ltdc_ex.h", "C++", 15, 0, 0, 0, 54, 18, 87
"f:\Working\中医\中医装备代码8-20出差回\2023-12-9-SWD&XWTT\Drivers\STM32H7xx_HAL_Driver\Inc\stm32h7xx_hal_mdios.h", "C++", 199, 0, 0, 0, 322, 87, 608
"f:\Working\中医\中医装备代码8-20出差回\2023-12-9-SWD&XWTT\Drivers\STM32H7xx_HAL_Driver\Inc\stm32h7xx_hal_mdma.h", "C++", 294, 0, 0, 0, 380, 155, 829
"f:\Working\中医\中医装备代码8-20出差回\2023-12-9-SWD&XWTT\Drivers\STM32H7xx_HAL_Driver\Inc\stm32h7xx_hal_mmc.h", "C++", 243, 0, 0, 0, 418, 96, 757
"f:\Working\中医\中医装备代码8-20出差回\2023-12-9-SWD&XWTT\Drivers\STM32H7xx_HAL_Driver\Inc\stm32h7xx_hal_mmc_ex.h", "C++", 23, 0, 0, 0, 69, 22, 114
"f:\Working\中医\中医装备代码8-20出差回\2023-12-9-SWD&XWTT\Drivers\STM32H7xx_HAL_Driver\Inc\stm32h7xx_hal_nand.h", "C++", 134, 0, 0, 0, 153, 75, 362
"f:\Working\中医\中医装备代码8-20出差回\2023-12-9-SWD&XWTT\Drivers\STM32H7xx_HAL_Driver\Inc\stm32h7xx_hal_nor.h", "C++", 117, 0, 0, 0, 148, 57, 322
"f:\Working\中医\中医装备代码8-20出差回\2023-12-9-SWD&XWTT\Drivers\STM32H7xx_HAL_Driver\Inc\stm32h7xx_hal_opamp.h", "C++", 128, 0, 0, 0, 218, 106, 452
"f:\Working\中医\中医装备代码8-20出差回\2023-12-9-SWD&XWTT\Drivers\STM32H7xx_HAL_Driver\Inc\stm32h7xx_hal_opamp_ex.h", "C++", 12, 0, 0, 0, 57, 15, 84
"f:\Working\中医\中医装备代码8-20出差回\2023-12-9-SWD&XWTT\Drivers\STM32H7xx_HAL_Driver\Inc\stm32h7xx_hal_pcd.h", "C++", 206, 0, 0, 0, 154, 77, 437
"f:\Working\中医\中医装备代码8-20出差回\2023-12-9-SWD&XWTT\Drivers\STM32H7xx_HAL_Driver\Inc\stm32h7xx_hal_pcd_ex.h", "C++", 23, 0, 0, 0, 49, 20, 92
"f:\Working\中医\中医装备代码8-20出差回\2023-12-9-SWD&XWTT\Drivers\STM32H7xx_HAL_Driver\Inc\stm32h7xx_hal_pwr.h", "C++", 199, 0, 0, 0, 326, 73, 598
"f:\Working\中医\中医装备代码8-20出差回\2023-12-9-SWD&XWTT\Drivers\STM32H7xx_HAL_Driver\Inc\stm32h7xx_hal_pwr_ex.h", "C++", 252, 0, 0, 0, 296, 91, 639
"f:\Working\中医\中医装备代码8-20出差回\2023-12-9-SWD&XWTT\Drivers\STM32H7xx_HAL_Driver\Inc\stm32h7xx_hal_qspi.h", "C++", 296, 0, 0, 0, 347, 100, 743
"f:\Working\中医\中医装备代码8-20出差回\2023-12-9-SWD&XWTT\Drivers\STM32H7xx_HAL_Driver\Inc\stm32h7xx_hal_ramecc.h", "C++", 74, 0, 0, 0, 180, 56, 310
"f:\Working\中医\中医装备代码8-20出差回\2023-12-9-SWD&XWTT\Drivers\STM32H7xx_HAL_Driver\Inc\stm32h7xx_hal_rcc.h", "C++", 4448, 0, 0, 0, 1201, 852, 6501
"f:\Working\中医\中医装备代码8-20出差回\2023-12-9-SWD&XWTT\Drivers\STM32H7xx_HAL_Driver\Inc\stm32h7xx_hal_rcc_ex.h", "C++", 1036, 0, 0, 0, 1765, 476, 3277
"f:\Working\中医\中医装备代码8-20出差回\2023-12-9-SWD&XWTT\Drivers\STM32H7xx_HAL_Driver\Inc\stm32h7xx_hal_rng.h", "C++", 108, 0, 0, 0, 203, 68, 379
"f:\Working\中医\中医装备代码8-20出差回\2023-12-9-SWD&XWTT\Drivers\STM32H7xx_HAL_Driver\Inc\stm32h7xx_hal_rtc.h", "C++", 334, 0, 0, 0, 461, 158, 953
"f:\Working\中医\中医装备代码8-20出差回\2023-12-9-SWD&XWTT\Drivers\STM32H7xx_HAL_Driver\Inc\stm32h7xx_hal_rtc_ex.h", "C++", 319, 0, 0, 0, 698, 168, 1185
"f:\Working\中医\中医装备代码8-20出差回\2023-12-9-SWD&XWTT\Drivers\STM32H7xx_HAL_Driver\Inc\stm32h7xx_hal_sai.h", "C++", 364, 0, 0, 0, 451, 152, 967
"f:\Working\中医\中医装备代码8-20出差回\2023-12-9-SWD&XWTT\Drivers\STM32H7xx_HAL_Driver\Inc\stm32h7xx_hal_sai_ex.h", "C++", 18, 0, 0, 0, 68, 20, 106
"f:\Working\中医\中医装备代码8-20出差回\2023-12-9-SWD&XWTT\Drivers\STM32H7xx_HAL_Driver\Inc\stm32h7xx_hal_sd.h", "C++", 278, 0, 0, 0, 420, 100, 798
"f:\Working\中医\中医装备代码8-20出差回\2023-12-9-SWD&XWTT\Drivers\STM32H7xx_HAL_Driver\Inc\stm32h7xx_hal_sd_ex.h", "C++", 23, 0, 0, 0, 69, 22, 114
"f:\Working\中医\中医装备代码8-20出差回\2023-12-9-SWD&XWTT\Drivers\STM32H7xx_HAL_Driver\Inc\stm32h7xx_hal_sdram.h", "C++", 87, 0, 0, 0, 99, 42, 228
"f:\Working\中医\中医装备代码8-20出差回\2023-12-9-SWD&XWTT\Drivers\STM32H7xx_HAL_Driver\Inc\stm32h7xx_hal_smartcard.h", "C++", 570, 0, 0, 0, 635, 164, 1369
"f:\Working\中医\中医装备代码8-20出差回\2023-12-9-SWD&XWTT\Drivers\STM32H7xx_HAL_Driver\Inc\stm32h7xx_hal_smartcard_ex.h", "C++", 122, 0, 0, 0, 171, 46, 339
"f:\Working\中医\中医装备代码8-20出差回\2023-12-9-SWD&XWTT\Drivers\STM32H7xx_HAL_Driver\Inc\stm32h7xx_hal_smbus.h", "C++", 266, 0, 0, 0, 357, 121, 744
"f:\Working\中医\中医装备代码8-20出差回\2023-12-9-SWD&XWTT\Drivers\STM32H7xx_HAL_Driver\Inc\stm32h7xx_hal_spdifrx.h", "C++", 207, 0, 0, 0, 302, 98, 607
"f:\Working\中医\中医装备代码8-20出差回\2023-12-9-SWD&XWTT\Drivers\STM32H7xx_HAL_Driver\Inc\stm32h7xx_hal_spi.h", "C++", 495, 0, 0, 0, 446, 152, 1093
"f:\Working\中医\中医装备代码8-20出差回\2023-12-9-SWD&XWTT\Drivers\STM32H7xx_HAL_Driver\Inc\stm32h7xx_hal_spi_ex.h", "C++", 13, 0, 0, 0, 51, 14, 78
"f:\Working\中医\中医装备代码8-20出差回\2023-12-9-SWD&XWTT\Drivers\STM32H7xx_HAL_Driver\Inc\stm32h7xx_hal_sram.h", "C++", 79, 0, 0, 0, 99, 44, 222
"f:\Working\中医\中医装备代码8-20出差回\2023-12-9-SWD&XWTT\Drivers\STM32H7xx_HAL_Driver\Inc\stm32h7xx_hal_swpmi.h", "C++", 165, 0, 0, 0, 276, 80, 521
"f:\Working\中医\中医装备代码8-20出差回\2023-12-9-SWD&XWTT\Drivers\STM32H7xx_HAL_Driver\Inc\stm32h7xx_hal_tim.h", "C++", 984, 0, 0, 0, 1007, 235, 2226
"f:\Working\中医\中医装备代码8-20出差回\2023-12-9-SWD&XWTT\Drivers\STM32H7xx_HAL_Driver\Inc\stm32h7xx_hal_tim_ex.h", "C++", 232, 0, 0, 0, 198, 67, 497
"f:\Working\中医\中医装备代码8-20出差回\2023-12-9-SWD&XWTT\Drivers\STM32H7xx_HAL_Driver\Inc\stm32h7xx_hal_uart.h", "C++", 510, 0, 0, 0, 942, 198, 1650
"f:\Working\中医\中医装备代码8-20出差回\2023-12-9-SWD&XWTT\Drivers\STM32H7xx_HAL_Driver\Inc\stm32h7xx_hal_uart_ex.h", "C++", 662, 0, 0, 0, 157, 46, 865
"f:\Working\中医\中医装备代码8-20出差回\2023-12-9-SWD&XWTT\Drivers\STM32H7xx_HAL_Driver\Inc\stm32h7xx_hal_usart.h", "C++", 565, 0, 0, 0, 485, 126, 1176
"f:\Working\中医\中医装备代码8-20出差回\2023-12-9-SWD&XWTT\Drivers\STM32H7xx_HAL_Driver\Inc\stm32h7xx_hal_usart_ex.h", "C++", 101, 0, 0, 0, 148, 37, 286
"f:\Working\中医\中医装备代码8-20出差回\2023-12-9-SWD&XWTT\Drivers\STM32H7xx_HAL_Driver\Inc\stm32h7xx_hal_wwdg.h", "C++", 78, 0, 0, 0, 176, 54, 308
"f:\Working\中医\中医装备代码8-20出差回\2023-12-9-SWD&XWTT\Drivers\STM32H7xx_HAL_Driver\Inc\stm32h7xx_ll_adc.h", "C++", 1746, 0, 0, 0, 5003, 429, 7178
"f:\Working\中医\中医装备代码8-20出差回\2023-12-9-SWD&XWTT\Drivers\STM32H7xx_HAL_Driver\Inc\stm32h7xx_ll_bdma.h", "C++", 680, 0, 0, 0, 1475, 208, 2363
"f:\Working\中医\中医装备代码8-20出差回\2023-12-9-SWD&XWTT\Drivers\STM32H7xx_HAL_Driver\Inc\stm32h7xx_ll_bus.h", "C++", 938, 0, 0, 0, 4807, 249, 5994
"f:\Working\中医\中医装备代码8-20出差回\2023-12-9-SWD&XWTT\Drivers\STM32H7xx_HAL_Driver\Inc\stm32h7xx_ll_comp.h", "C++", 158, 0, 0, 0, 516, 82, 756
"f:\Working\中医\中医装备代码8-20出差回\2023-12-9-SWD&XWTT\Drivers\STM32H7xx_HAL_Driver\Inc\stm32h7xx_ll_cortex.h", "C++", 194, 0, 0, 0, 411, 65, 670
"f:\Working\中医\中医装备代码8-20出差回\2023-12-9-SWD&XWTT\Drivers\STM32H7xx_HAL_Driver\Inc\stm32h7xx_ll_crc.h", "C++", 111, 0, 0, 0, 298, 56, 465
"f:\Working\中医\中医装备代码8-20出差回\2023-12-9-SWD&XWTT\Drivers\STM32H7xx_HAL_Driver\Inc\stm32h7xx_ll_dac.h", "C++", 477, 0, 0, 0, 1160, 168, 1805
"f:\Working\中医\中医装备代码8-20出差回\2023-12-9-SWD&XWTT\Drivers\STM32H7xx_HAL_Driver\Inc\stm32h7xx_ll_delayblock.h", "C++", 13, 0, 0, 0, 54, 20, 87
"f:\Working\中医\中医装备代码8-20出差回\2023-12-9-SWD&XWTT\Drivers\STM32H7xx_HAL_Driver\Inc\stm32h7xx_ll_dma.h", "C++", 792, 0, 0, 0, 2124, 275, 3191
"f:\Working\中医\中医装备代码8-20出差回\2023-12-9-SWD&XWTT\Drivers\STM32H7xx_HAL_Driver\Inc\stm32h7xx_ll_dma2d.h", "C++", 608, 0, 0, 0, 1269, 215, 2092
"f:\Working\中医\中医装备代码8-20出差回\2023-12-9-SWD&XWTT\Drivers\STM32H7xx_HAL_Driver\Inc\stm32h7xx_ll_dmamux.h", "C++", 681, 0, 0, 0, 1434, 197, 2312
"f:\Working\中医\中医装备代码8-20出差回\2023-12-9-SWD&XWTT\Drivers\STM32H7xx_HAL_Driver\Inc\stm32h7xx_ll_exti.h", "C++", 507, 0, 0, 0, 2433, 198, 3138
"f:\Working\中医\中医装备代码8-20出差回\2023-12-9-SWD&XWTT\Drivers\STM32H7xx_HAL_Driver\Inc\stm32h7xx_ll_fmc.h", "C++", 363, 0, 0, 0, 641, 159, 1163
"f:\Working\中医\中医装备代码8-20出差回\2023-12-9-SWD&XWTT\Drivers\STM32H7xx_HAL_Driver\Inc\stm32h7xx_ll_gpio.h", "C++", 189, 0, 0, 0, 728, 69, 986
"f:\Working\中医\中医装备代码8-20出差回\2023-12-9-SWD&XWTT\Drivers\STM32H7xx_HAL_Driver\Inc\stm32h7xx_ll_hrtim.h", "C++", 2875, 0, 0, 0, 7089, 531, 10495
"f:\Working\中医\中医装备代码8-20出差回\2023-12-9-SWD&XWTT\Drivers\STM32H7xx_HAL_Driver\Inc\stm32h7xx_ll_hsem.h", "C++", 154, 0, 0, 0, 693, 55, 902
"f:\Working\中医\中医装备代码8-20出差回\2023-12-9-SWD&XWTT\Drivers\STM32H7xx_HAL_Driver\Inc\stm32h7xx_ll_i2c.h", "C++", 669, 0, 0, 0, 1362, 198, 2229
"f:\Working\中医\中医装备代码8-20出差回\2023-12-9-SWD&XWTT\Drivers\STM32H7xx_HAL_Driver\Inc\stm32h7xx_ll_iwdg.h", "C++", 84, 0, 0, 0, 213, 46, 343
"f:\Working\中医\中医装备代码8-20出差回\2023-12-9-SWD&XWTT\Drivers\STM32H7xx_HAL_Driver\Inc\stm32h7xx_ll_lptim.h", "C++", 410, 0, 0, 0, 906, 140, 1456
"f:\Working\中医\中医装备代码8-20出差回\2023-12-9-SWD&XWTT\Drivers\STM32H7xx_HAL_Driver\Inc\stm32h7xx_ll_lpuart.h", "C++", 821, 0, 0, 0, 1566, 248, 2635
"f:\Working\中医\中医装备代码8-20出差回\2023-12-9-SWD&XWTT\Drivers\STM32H7xx_HAL_Driver\Inc\stm32h7xx_ll_mdma.h", "C++", 804, 0, 0, 0, 3198, 322, 4324
"f:\Working\中医\中医装备代码8-20出差回\2023-12-9-SWD&XWTT\Drivers\STM32H7xx_HAL_Driver\Inc\stm32h7xx_ll_opamp.h", "C++", 170, 0, 0, 0, 556, 94, 820
"f:\Working\中医\中医装备代码8-20出差回\2023-12-9-SWD&XWTT\Drivers\STM32H7xx_HAL_Driver\Inc\stm32h7xx_ll_pwr.h", "C++", 614, 0, 0, 0, 991, 160, 1765
"f:\Working\中医\中医装备代码8-20出差回\2023-12-9-SWD&XWTT\Drivers\STM32H7xx_HAL_Driver\Inc\stm32h7xx_ll_rcc.h", "C++", 1779, 0, 0, 0, 3182, 476, 5437
"f:\Working\中医\中医装备代码8-20出差回\2023-12-9-SWD&XWTT\Drivers\STM32H7xx_HAL_Driver\Inc\stm32h7xx_ll_rng.h", "C++", 101, 0, 0, 0, 245, 56, 402
"f:\Working\中医\中医装备代码8-20出差回\2023-12-9-SWD&XWTT\Drivers\STM32H7xx_HAL_Driver\Inc\stm32h7xx_ll_rtc.h", "C++", 1104, 0, 0, 0, 2392, 331, 3827
"f:\Working\中医\中医装备代码8-20出差回\2023-12-9-SWD&XWTT\Drivers\STM32H7xx_HAL_Driver\Inc\stm32h7xx_ll_sdmmc.h", "C++", 425, 0, 0, 0, 548, 130, 1103
"f:\Working\中医\中医装备代码8-20出差回\2023-12-9-SWD&XWTT\Drivers\STM32H7xx_HAL_Driver\Inc\stm32h7xx_ll_spi.h", "C++", 1143, 0, 0, 0, 2221, 345, 3709
"f:\Working\中医\中医装备代码8-20出差回\2023-12-9-SWD&XWTT\Drivers\STM32H7xx_HAL_Driver\Inc\stm32h7xx_ll_swpmi.h", "C++", 390, 0, 0, 0, 719, 134, 1243
"f:\Working\中医\中医装备代码8-20出差回\2023-12-9-SWD&XWTT\Drivers\STM32H7xx_HAL_Driver\Inc\stm32h7xx_ll_system.h", "C++", 679, 0, 0, 0, 1205, 182, 2066
"f:\Working\中医\中医装备代码8-20出差回\2023-12-9-SWD&XWTT\Drivers\STM32H7xx_HAL_Driver\Inc\stm32h7xx_ll_tim.h", "C++", 1355, 0, 0, 0, 2904, 358, 4617
"f:\Working\中医\中医装备代码8-20出差回\2023-12-9-SWD&XWTT\Drivers\STM32H7xx_HAL_Driver\Inc\stm32h7xx_ll_usart.h", "C++", 1268, 0, 0, 0, 2749, 362, 4379
"f:\Working\中医\中医装备代码8-20出差回\2023-12-9-SWD&XWTT\Drivers\STM32H7xx_HAL_Driver\Inc\stm32h7xx_ll_usb.h", "C++", 234, 0, 0, 0, 186, 92, 512
"f:\Working\中医\中医装备代码8-20出差回\2023-12-9-SWD&XWTT\Drivers\STM32H7xx_HAL_Driver\Inc\stm32h7xx_ll_utils.h", "C++", 77, 0, 0, 0, 213, 56, 346
"f:\Working\中医\中医装备代码8-20出差回\2023-12-9-SWD&XWTT\Drivers\STM32H7xx_HAL_Driver\Inc\stm32h7xx_ll_wwdg.h", "C++", 71, 0, 0, 0, 224, 37, 332
"f:\Working\中医\中医装备代码8-20出差回\2023-12-9-SWD&XWTT\Drivers\STM32H7xx_HAL_Driver\Src\stm32h7xx_hal.c", "C", 0, 486, 0, 0, 616, 142, 1244
"f:\Working\中医\中医装备代码8-20出差回\2023-12-9-SWD&XWTT\Drivers\STM32H7xx_HAL_Driver\Src\stm32h7xx_hal_adc.c", "C", 0, 1707, 0, 0, 1540, 434, 3681
"f:\Working\中医\中医装备代码8-20出差回\2023-12-9-SWD&XWTT\Drivers\STM32H7xx_HAL_Driver\Src\stm32h7xx_hal_adc_ex.c", "C", 0, 1120, 0, 0, 1001, 331, 2452
"f:\Working\中医\中医装备代码8-20出差回\2023-12-9-SWD&XWTT\Drivers\STM32H7xx_HAL_Driver\Src\stm32h7xx_hal_cec.c", "C", 0, 412, 0, 0, 479, 111, 1002
"f:\Working\中医\中医装备代码8-20出差回\2023-12-9-SWD&XWTT\Drivers\STM32H7xx_HAL_Driver\Src\stm32h7xx_hal_comp.c", "C", 0, 505, 0, 0, 563, 142, 1210
"f:\Working\中医\中医装备代码8-20出差回\2023-12-9-SWD&XWTT\Drivers\STM32H7xx_HAL_Driver\Src\stm32h7xx_hal_cortex.c", "C", 0, 147, 0, 0, 334, 53, 534
"f:\Working\中医\中医装备代码8-20出差回\2023-12-9-SWD&XWTT\Drivers\STM32H7xx_HAL_Driver\Src\stm32h7xx_hal_crc.c", "C", 0, 181, 0, 0, 268, 70, 519
"f:\Working\中医\中医装备代码8-20出差回\2023-12-9-SWD&XWTT\Drivers\STM32H7xx_HAL_Driver\Src\stm32h7xx_hal_crc_ex.c", "C", 0, 60, 0, 0, 132, 34, 226
"f:\Working\中医\中医装备代码8-20出差回\2023-12-9-SWD&XWTT\Drivers\STM32H7xx_HAL_Driver\Src\stm32h7xx_hal_cryp.c", "C", 0, 2685, 0, 0, 1474, 663, 4822
"f:\Working\中医\中医装备代码8-20出差回\2023-12-9-SWD&XWTT\Drivers\STM32H7xx_HAL_Driver\Src\stm32h7xx_hal_cryp_ex.c", "C", 0, 238, 0, 0, 152, 57, 447
"f:\Working\中医\中医装备代码8-20出差回\2023-12-9-SWD&XWTT\Drivers\STM32H7xx_HAL_Driver\Src\stm32h7xx_hal_dac.c", "C", 0, 552, 0, 0, 805, 152, 1509
"f:\Working\中医\中医装备代码8-20出差回\2023-12-9-SWD&XWTT\Drivers\STM32H7xx_HAL_Driver\Src\stm32h7xx_hal_dac_ex.c", "C", 0, 185, 0, 0, 333, 102, 620
"f:\Working\中医\中医装备代码8-20出差回\2023-12-9-SWD&XWTT\Drivers\STM32H7xx_HAL_Driver\Src\stm32h7xx_hal_dcmi.c", "C", 0, 487, 0, 0, 543, 163, 1193
"f:\Working\中医\中医装备代码8-20出差回\2023-12-9-SWD&XWTT\Drivers\STM32H7xx_HAL_Driver\Src\stm32h7xx_hal_dfsdm.c", "C", 0, 1801, 0, 0, 1432, 341, 3574
"f:\Working\中医\中医装备代码8-20出差回\2023-12-9-SWD&XWTT\Drivers\STM32H7xx_HAL_Driver\Src\stm32h7xx_hal_dma.c", "C", 0, 1054, 0, 0, 639, 307, 2000
"f:\Working\中医\中医装备代码8-20出差回\2023-12-9-SWD&XWTT\Drivers\STM32H7xx_HAL_Driver\Src\stm32h7xx_hal_dma2d.c", "C", 0, 849, 0, 0, 860, 299, 2008
"f:\Working\中医\中医装备代码8-20出差回\2023-12-9-SWD&XWTT\Drivers\STM32H7xx_HAL_Driver\Src\stm32h7xx_hal_dma_ex.c", "C", 0, 308, 0, 0, 292, 106, 706
"f:\Working\中医\中医装备代码8-20出差回\2023-12-9-SWD&XWTT\Drivers\STM32H7xx_HAL_Driver\Src\stm32h7xx_hal_dsi.c", "C", 0, 1288, 0, 0, 1014, 404, 2706
"f:\Working\中医\中医装备代码8-20出差回\2023-12-9-SWD&XWTT\Drivers\STM32H7xx_HAL_Driver\Src\stm32h7xx_hal_eth.c", "C", 0, 1514, 0, 0, 1058, 421, 2993
"f:\Working\中医\中医装备代码8-20出差回\2023-12-9-SWD&XWTT\Drivers\STM32H7xx_HAL_Driver\Src\stm32h7xx_hal_eth_ex.c", "C", 0, 228, 0, 0, 264, 62, 554
"f:\Working\中医\中医装备代码8-20出差回\2023-12-9-SWD&XWTT\Drivers\STM32H7xx_HAL_Driver\Src\stm32h7xx_hal_exti.c", "C", 0, 431, 0, 0, 323, 124, 878
"f:\Working\中医\中医装备代码8-20出差回\2023-12-9-SWD&XWTT\Drivers\STM32H7xx_HAL_Driver\Src\stm32h7xx_hal_fdcan.c", "C", 0, 3121, 0, 0, 2215, 834, 6170
"f:\Working\中医\中医装备代码8-20出差回\2023-12-9-SWD&XWTT\Drivers\STM32H7xx_HAL_Driver\Src\stm32h7xx_hal_flash.c", "C", 0, 471, 0, 0, 402, 139, 1012
"f:\Working\中医\中医装备代码8-20出差回\2023-12-9-SWD&XWTT\Drivers\STM32H7xx_HAL_Driver\Src\stm32h7xx_hal_flash_ex.c", "C", 0, 758, 0, 0, 652, 207, 1617
"f:\Working\中医\中医装备代码8-20出差回\2023-12-9-SWD&XWTT\Drivers\STM32H7xx_HAL_Driver\Src\stm32h7xx_hal_gpio.c", "C", 0, 222, 0, 0, 279, 60, 561
"f:\Working\中医\中医装备代码8-20出差回\2023-12-9-SWD&XWTT\Drivers\STM32H7xx_HAL_Driver\Src\stm32h7xx_hal_hash.c", "C", 0, 1260, 0, 0, 1426, 383, 3069
"f:\Working\中医\中医装备代码8-20出差回\2023-12-9-SWD&XWTT\Drivers\STM32H7xx_HAL_Driver\Src\stm32h7xx_hal_hash_ex.c", "C", 0, 141, 0, 0, 700, 76, 917
"f:\Working\中医\中医装备代码8-20出差回\2023-12-9-SWD&XWTT\Drivers\STM32H7xx_HAL_Driver\Src\stm32h7xx_hal_hcd.c", "C", 0, 921, 0, 0, 530, 188, 1639
"f:\Working\中医\中医装备代码8-20出差回\2023-12-9-SWD&XWTT\Drivers\STM32H7xx_HAL_Driver\Src\stm32h7xx_hal_hrtim.c", "C", 0, 4550, 0, 0, 3402, 1315, 9267
"f:\Working\中医\中医装备代码8-20出差回\2023-12-9-SWD&XWTT\Drivers\STM32H7xx_HAL_Driver\Src\stm32h7xx_hal_hsem.c", "C", 0, 135, 0, 0, 257, 50, 442
"f:\Working\中医\中医装备代码8-20出差回\2023-12-9-SWD&XWTT\Drivers\STM32H7xx_HAL_Driver\Src\stm32h7xx_hal_i2c.c", "C", 0, 3367, 0, 0, 2209, 948, 6524
"f:\Working\中医\中医装备代码8-20出差回\2023-12-9-SWD&XWTT\Drivers\STM32H7xx_HAL_Driver\Src\stm32h7xx_hal_i2c_ex.c", "C", 0, 98, 0, 0, 182, 60, 340
"f:\Working\中医\中医装备代码8-20出差回\2023-12-9-SWD&XWTT\Drivers\STM32H7xx_HAL_Driver\Src\stm32h7xx_hal_i2s.c", "C", 0, 846, 0, 0, 782, 236, 1864
"f:\Working\中医\中医装备代码8-20出差回\2023-12-9-SWD&XWTT\Drivers\STM32H7xx_HAL_Driver\Src\stm32h7xx_hal_i2s_ex.c", "C", 0, 563, 0, 0, 446, 144, 1153
"f:\Working\中医\中医装备代码8-20出差回\2023-12-9-SWD&XWTT\Drivers\STM32H7xx_HAL_Driver\Src\stm32h7xx_hal_irda.c", "C", 0, 1318, 0, 0, 1203, 378, 2899
"f:\Working\中医\中医装备代码8-20出差回\2023-12-9-SWD&XWTT\Drivers\STM32H7xx_HAL_Driver\Src\stm32h7xx_hal_iwdg.c", "C", 0, 42, 0, 0, 195, 29, 266
"f:\Working\中医\中医装备代码8-20出差回\2023-12-9-SWD&XWTT\Drivers\STM32H7xx_HAL_Driver\Src\stm32h7xx_hal_jpeg.c", "C", 0, 2275, 0, 0, 1333, 566, 4174
"f:\Working\中医\中医装备代码8-20出差回\2023-12-9-SWD&XWTT\Drivers\STM32H7xx_HAL_Driver\Src\stm32h7xx_hal_lptim.c", "C", 0, 1099, 0, 0, 987, 431, 2517
"f:\Working\中医\中医装备代码8-20出差回\2023-12-9-SWD&XWTT\Drivers\STM32H7xx_HAL_Driver\Src\stm32h7xx_hal_ltdc.c", "C", 0, 782, 0, 0, 991, 391, 2164
"f:\Working\中医\中医装备代码8-20出差回\2023-12-9-SWD&XWTT\Drivers\STM32H7xx_HAL_Driver\Src\stm32h7xx_hal_ltdc_ex.c", "C", 0, 23, 0, 0, 100, 27, 150
"f:\Working\中医\中医装备代码8-20出差回\2023-12-9-SWD&XWTT\Drivers\STM32H7xx_HAL_Driver\Src\stm32h7xx_hal_mdios.c", "C", 0, 361, 0, 0, 468, 129, 958
"f:\Working\中医\中医装备代码8-20出差回\2023-12-9-SWD&XWTT\Drivers\STM32H7xx_HAL_Driver\Src\stm32h7xx_hal_mdma.c", "C", 0, 938, 0, 0, 697, 274, 1909
"f:\Working\中医\中医装备代码8-20出差回\2023-12-9-SWD&XWTT\Drivers\STM32H7xx_HAL_Driver\Src\stm32h7xx_hal_mmc.c", "C", 0, 1824, 0, 0, 930, 375, 3129
"f:\Working\中医\中医装备代码8-20出差回\2023-12-9-SWD&XWTT\Drivers\STM32H7xx_HAL_Driver\Src\stm32h7xx_hal_mmc_ex.c", "C", 0, 134, 0, 0, 123, 48, 305
"f:\Working\中医\中医装备代码8-20出差回\2023-12-9-SWD&XWTT\Drivers\STM32H7xx_HAL_Driver\Src\stm32h7xx_hal_msp_template.c", "C", 0, 13, 0, 0, 71, 18, 102
"f:\Working\中医\中医装备代码8-20出差回\2023-12-9-SWD&XWTT\Drivers\STM32H7xx_HAL_Driver\Src\stm32h7xx_hal_nand.c", "C", 0, 1248, 0, 0, 649, 288, 2185
"f:\Working\中医\中医装备代码8-20出差回\2023-12-9-SWD&XWTT\Drivers\STM32H7xx_HAL_Driver\Src\stm32h7xx_hal_nor.c", "C", 0, 624, 0, 0, 489, 172, 1285
"f:\Working\中医\中医装备代码8-20出差回\2023-12-9-SWD&XWTT\Drivers\STM32H7xx_HAL_Driver\Src\stm32h7xx_hal_opamp.c", "C", 0, 489, 0, 0, 555, 131, 1175
"f:\Working\中医\中医装备代码8-20出差回\2023-12-9-SWD&XWTT\Drivers\STM32H7xx_HAL_Driver\Src\stm32h7xx_hal_opamp_ex.c", "C", 0, 194, 0, 0, 179, 63, 436
"f:\Working\中医\中医装备代码8-20出差回\2023-12-9-SWD&XWTT\Drivers\STM32H7xx_HAL_Driver\Src\stm32h7xx_hal_pcd.c", "C", 0, 1230, 0, 0, 667, 327, 2224
"f:\Working\中医\中医装备代码8-20出差回\2023-12-9-SWD&XWTT\Drivers\STM32H7xx_HAL_Driver\Src\stm32h7xx_hal_pcd_ex.c", "C", 0, 146, 0, 0, 149, 54, 349
"f:\Working\中医\中医装备代码8-20出差回\2023-12-9-SWD&XWTT\Drivers\STM32H7xx_HAL_Driver\Src\stm32h7xx_hal_pwr.c", "C", 0, 175, 0, 0, 399, 62, 636
"f:\Working\中医\中医装备代码8-20出差回\2023-12-9-SWD&XWTT\Drivers\STM32H7xx_HAL_Driver\Src\stm32h7xx_hal_pwr_ex.c", "C", 0, 603, 0, 0, 863, 179, 1645
"f:\Working\中医\中医装备代码8-20出差回\2023-12-9-SWD&XWTT\Drivers\STM32H7xx_HAL_Driver\Src\stm32h7xx_hal_qspi.c", "C", 0, 1309, 0, 0, 945, 362, 2616
"f:\Working\中医\中医装备代码8-20出差回\2023-12-9-SWD&XWTT\Drivers\STM32H7xx_HAL_Driver\Src\stm32h7xx_hal_ramecc.c", "C", 0, 186, 0, 0, 297, 94, 577
"f:\Working\中医\中医装备代码8-20出差回\2023-12-9-SWD&XWTT\Drivers\STM32H7xx_HAL_Driver\Src\stm32h7xx_hal_rcc.c", "C", 0, 786, 0, 0, 559, 192, 1537
"f:\Working\中医\中医装备代码8-20出差回\2023-12-9-SWD&XWTT\Drivers\STM32H7xx_HAL_Driver\Src\stm32h7xx_hal_rcc_ex.c", "C", 0, 1640, 0, 0, 802, 466, 2908
"f:\Working\中医\中医装备代码8-20出差回\2023-12-9-SWD&XWTT\Drivers\STM32H7xx_HAL_Driver\Src\stm32h7xx_hal_rng.c", "C", 0, 316, 0, 0, 400, 99, 815
"f:\Working\中医\中医装备代码8-20出差回\2023-12-9-SWD&XWTT\Drivers\STM32H7xx_HAL_Driver\Src\stm32h7xx_hal_rtc.c", "C", 0, 894, 0, 0, 690, 275, 1859
"f:\Working\中医\中医装备代码8-20出差回\2023-12-9-SWD&XWTT\Drivers\STM32H7xx_HAL_Driver\Src\stm32h7xx_hal_rtc_ex.c", "C", 0, 858, 0, 0, 744, 374, 1976
"f:\Working\中医\中医装备代码8-20出差回\2023-12-9-SWD&XWTT\Drivers\STM32H7xx_HAL_Driver\Src\stm32h7xx_hal_sai.c", "C", 0, 1544, 0, 0, 1003, 295, 2842
"f:\Working\中医\中医装备代码8-20出差回\2023-12-9-SWD&XWTT\Drivers\STM32H7xx_HAL_Driver\Src\stm32h7xx_hal_sai_ex.c", "C", 0, 36, 0, 0, 78, 18, 132
"f:\Working\中医\中医装备代码8-20出差回\2023-12-9-SWD&XWTT\Drivers\STM32H7xx_HAL_Driver\Src\stm32h7xx_hal_sd.c", "C", 0, 2452, 0, 0, 1045, 484, 3981
"f:\Working\中医\中医装备代码8-20出差回\2023-12-9-SWD&XWTT\Drivers\STM32H7xx_HAL_Driver\Src\stm32h7xx_hal_sd_ex.c", "C", 0, 151, 0, 0, 127, 50, 328
"f:\Working\中医\中医装备代码8-20出差回\2023-12-9-SWD&XWTT\Drivers\STM32H7xx_HAL_Driver\Src\stm32h7xx_hal_sdram.c", "C", 0, 594, 0, 0, 562, 156, 1312
"f:\Working\中医\中医装备代码8-20出差回\2023-12-9-SWD&XWTT\Drivers\STM32H7xx_HAL_Driver\Src\stm32h7xx_hal_smartcard.c", "C", 0, 1488, 0, 0, 1237, 412, 3137
"f:\Working\中医\中医装备代码8-20出差回\2023-12-9-SWD&XWTT\Drivers\STM32H7xx_HAL_Driver\Src\stm32h7xx_hal_smartcard_ex.c", "C", 0, 141, 0, 0, 266, 88, 495
"f:\Working\中医\中医装备代码8-20出差回\2023-12-9-SWD&XWTT\Drivers\STM32H7xx_HAL_Driver\Src\stm32h7xx_hal_smbus.c", "C", 0, 1272, 0, 0, 1033, 369, 2674
"f:\Working\中医\中医装备代码8-20出差回\2023-12-9-SWD&XWTT\Drivers\STM32H7xx_HAL_Driver\Src\stm32h7xx_hal_spdifrx.c", "C", 0, 742, 0, 0, 643, 251, 1636
"f:\Working\中医\中医装备代码8-20出差回\2023-12-9-SWD&XWTT\Drivers\STM32H7xx_HAL_Driver\Src\stm32h7xx_hal_spi.c", "C", 0, 2206, 0, 0, 1094, 475, 3775
"f:\Working\中医\中医装备代码8-20出差回\2023-12-9-SWD&XWTT\Drivers\STM32H7xx_HAL_Driver\Src\stm32h7xx_hal_spi_ex.c", "C", 0, 84, 0, 0, 113, 33, 230
"f:\Working\中医\中医装备代码8-20出差回\2023-12-9-SWD&XWTT\Drivers\STM32H7xx_HAL_Driver\Src\stm32h7xx_hal_sram.c", "C", 0, 458, 0, 0, 508, 147, 1113
"f:\Working\中医\中医装备代码8-20出差回\2023-12-9-SWD&XWTT\Drivers\STM32H7xx_HAL_Driver\Src\stm32h7xx_hal_swpmi.c", "C", 0, 975, 0, 0, 751, 224, 1950
"f:\Working\中医\中医装备代码8-20出差回\2023-12-9-SWD&XWTT\Drivers\STM32H7xx_HAL_Driver\Src\stm32h7xx_hal_tim.c", "C", 0, 3476, 0, 0, 2573, 986, 7035
"f:\Working\中医\中医装备代码8-20出差回\2023-12-9-SWD&XWTT\Drivers\STM32H7xx_HAL_Driver\Src\stm32h7xx_hal_tim_ex.c", "C", 0, 906, 0, 0, 1045, 331, 2282
"f:\Working\中医\中医装备代码8-20出差回\2023-12-9-SWD&XWTT\Drivers\STM32H7xx_HAL_Driver\Src\stm32h7xx_hal_timebase_rtc_alarm_template.c", "C", 0, 125, 0, 0, 139, 37, 301
"f:\Working\中医\中医装备代码8-20出差回\2023-12-9-SWD&XWTT\Drivers\STM32H7xx_HAL_Driver\Src\stm32h7xx_hal_timebase_rtc_wakeup_template.c", "C", 0, 100, 0, 0, 146, 37, 283
"f:\Working\中医\中医装备代码8-20出差回\2023-12-9-SWD&XWTT\Drivers\STM32H7xx_HAL_Driver\Src\stm32h7xx_hal_timebase_tim_template.c", "C", 0, 51, 0, 0, 96, 20, 167
"f:\Working\中医\中医装备代码8-20出差回\2023-12-9-SWD&XWTT\Drivers\STM32H7xx_HAL_Driver\Src\stm32h7xx_hal_uart.c", "C", 0, 2114, 0, 0, 1428, 574, 4116
"f:\Working\中医\中医装备代码8-20出差回\2023-12-9-SWD&XWTT\Drivers\STM32H7xx_HAL_Driver\Src\stm32h7xx_hal_uart_ex.c", "C", 0, 209, 0, 0, 396, 125, 730
"f:\Working\中医\中医装备代码8-20出差回\2023-12-9-SWD&XWTT\Drivers\STM32H7xx_HAL_Driver\Src\stm32h7xx_hal_usart.c", "C", 0, 1959, 0, 0, 1241, 476, 3676
"f:\Working\中医\中医装备代码8-20出差回\2023-12-9-SWD&XWTT\Drivers\STM32H7xx_HAL_Driver\Src\stm32h7xx_hal_usart_ex.c", "C", 0, 148, 0, 0, 281, 110, 539
"f:\Working\中医\中医装备代码8-20出差回\2023-12-9-SWD&XWTT\Drivers\STM32H7xx_HAL_Driver\Src\stm32h7xx_hal_wwdg.c", "C", 0, 102, 0, 0, 264, 44, 410
"f:\Working\中医\中医装备代码8-20出差回\2023-12-9-SWD&XWTT\Drivers\STM32H7xx_HAL_Driver\Src\stm32h7xx_ll_adc.c", "C", 0, 578, 0, 0, 396, 105, 1079
"f:\Working\中医\中医装备代码8-20出差回\2023-12-9-SWD&XWTT\Drivers\STM32H7xx_HAL_Driver\Src\stm32h7xx_ll_bdma.c", "C", 0, 146, 0, 0, 147, 50, 343
"f:\Working\中医\中医装备代码8-20出差回\2023-12-9-SWD&XWTT\Drivers\STM32H7xx_HAL_Driver\Src\stm32h7xx_ll_comp.c", "C", 0, 107, 0, 0, 113, 38, 258
"f:\Working\中医\中医装备代码8-20出差回\2023-12-9-SWD&XWTT\Drivers\STM32H7xx_HAL_Driver\Src\stm32h7xx_ll_crc.c", "C", 0, 26, 0, 0, 60, 22, 108
"f:\Working\中医\中医装备代码8-20出差回\2023-12-9-SWD&XWTT\Drivers\STM32H7xx_HAL_Driver\Src\stm32h7xx_ll_dac.c", "C", 0, 155, 0, 0, 111, 36, 302
"f:\Working\中医\中医装备代码8-20出差回\2023-12-9-SWD&XWTT\Drivers\STM32H7xx_HAL_Driver\Src\stm32h7xx_ll_delayblock.c", "C", 0, 47, 0, 0, 104, 27, 178
"f:\Working\中医\中医装备代码8-20出差回\2023-12-9-SWD&XWTT\Drivers\STM32H7xx_HAL_Driver\Src\stm32h7xx_ll_dma.c", "C", 0, 196, 0, 0, 166, 57, 419
"f:\Working\中医\中医装备代码8-20出差回\2023-12-9-SWD&XWTT\Drivers\STM32H7xx_HAL_Driver\Src\stm32h7xx_ll_dma2d.c", "C", 0, 340, 0, 0, 199, 84, 623
"f:\Working\中医\中医装备代码8-20出差回\2023-12-9-SWD&XWTT\Drivers\STM32H7xx_HAL_Driver\Src\stm32h7xx_ll_exti.c", "C", 0, 276, 0, 0, 131, 52, 459
"f:\Working\中医\中医装备代码8-20出差回\2023-12-9-SWD&XWTT\Drivers\STM32H7xx_HAL_Driver\Src\stm32h7xx_ll_fmc.c", "C", 0, 424, 0, 0, 501, 130, 1055
"f:\Working\中医\中医装备代码8-20出差回\2023-12-9-SWD&XWTT\Drivers\STM32H7xx_HAL_Driver\Src\stm32h7xx_ll_gpio.c", "C", 0, 173, 0, 0, 94, 42, 309
"f:\Working\中医\中医装备代码8-20出差回\2023-12-9-SWD&XWTT\Drivers\STM32H7xx_HAL_Driver\Src\stm32h7xx_ll_hrtim.c", "C", 0, 19, 0, 0, 52, 13, 84
"f:\Working\中医\中医装备代码8-20出差回\2023-12-9-SWD&XWTT\Drivers\STM32H7xx_HAL_Driver\Src\stm32h7xx_ll_i2c.c", "C", 0, 86, 0, 0, 115, 43, 244
"f:\Working\中医\中医装备代码8-20出差回\2023-12-9-SWD&XWTT\Drivers\STM32H7xx_HAL_Driver\Src\stm32h7xx_ll_lptim.c", "C", 0, 190, 0, 0, 117, 46, 353
"f:\Working\中医\中医装备代码8-20出差回\2023-12-9-SWD&XWTT\Drivers\STM32H7xx_HAL_Driver\Src\stm32h7xx_ll_lpuart.c", "C", 0, 103, 0, 0, 132, 49, 284
"f:\Working\中医\中医装备代码8-20出差回\2023-12-9-SWD&XWTT\Drivers\STM32H7xx_HAL_Driver\Src\stm32h7xx_ll_mdma.c", "C", 0, 316, 0, 0, 268, 103, 687
"f:\Working\中医\中医装备代码8-20出差回\2023-12-9-SWD&XWTT\Drivers\STM32H7xx_HAL_Driver\Src\stm32h7xx_ll_opamp.c", "C", 0, 86, 0, 0, 102, 36, 224
"f:\Working\中医\中医装备代码8-20出差回\2023-12-9-SWD&XWTT\Drivers\STM32H7xx_HAL_Driver\Src\stm32h7xx_ll_pwr.c", "C", 0, 11, 0, 0, 56, 16, 83
"f:\Working\中医\中医装备代码8-20出差回\2023-12-9-SWD&XWTT\Drivers\STM32H7xx_HAL_Driver\Src\stm32h7xx_ll_rcc.c", "C", 0, 987, 0, 0, 384, 248, 1619
"f:\Working\中医\中医装备代码8-20出差回\2023-12-9-SWD&XWTT\Drivers\STM32H7xx_HAL_Driver\Src\stm32h7xx_ll_rng.c", "C", 0, 31, 0, 0, 84, 24, 139
"f:\Working\中医\中医装备代码8-20出差回\2023-12-9-SWD&XWTT\Drivers\STM32H7xx_HAL_Driver\Src\stm32h7xx_ll_rtc.c", "C", 0, 504, 0, 0, 265, 114, 883
"f:\Working\中医\中医装备代码8-20出差回\2023-12-9-SWD&XWTT\Drivers\STM32H7xx_HAL_Driver\Src\stm32h7xx_ll_sdmmc.c", "C", 0, 729, 0, 0, 627, 221, 1577
"f:\Working\中医\中医装备代码8-20出差回\2023-12-9-SWD&XWTT\Drivers\STM32H7xx_HAL_Driver\Src\stm32h7xx_ll_spi.c", "C", 0, 392, 0, 0, 231, 104, 727
"f:\Working\中医\中医装备代码8-20出差回\2023-12-9-SWD&XWTT\Drivers\STM32H7xx_HAL_Driver\Src\stm32h7xx_ll_swpmi.c", "C", 0, 60, 0, 0, 88, 32, 180
"f:\Working\中医\中医装备代码8-20出差回\2023-12-9-SWD&XWTT\Drivers\STM32H7xx_HAL_Driver\Src\stm32h7xx_ll_tim.c", "C", 0, 726, 0, 0, 423, 232, 1381
"f:\Working\中医\中医装备代码8-20出差回\2023-12-9-SWD&XWTT\Drivers\STM32H7xx_HAL_Driver\Src\stm32h7xx_ll_usart.c", "C", 0, 251, 0, 0, 180, 66, 497
"f:\Working\中医\中医装备代码8-20出差回\2023-12-9-SWD&XWTT\Drivers\STM32H7xx_HAL_Driver\Src\stm32h7xx_ll_usb.c", "C", 0, 1206, 0, 0, 543, 254, 2003
"f:\Working\中医\中医装备代码8-20出差回\2023-12-9-SWD&XWTT\Drivers\STM32H7xx_HAL_Driver\Src\stm32h7xx_ll_utils.c", "C", 0, 404, 0, 0, 310, 94, 808
"f:\Working\中医\中医装备代码8-20出差回\2023-12-9-SWD&XWTT\Inc\FreeRTOSConfig.h", "C++", 49, 0, 0, 0, 70, 17, 136
"f:\Working\中医\中医装备代码8-20出差回\2023-12-9-SWD&XWTT\Inc\Includes\AHT15.h", "C++", 34, 0, 0, 0, 47, 31, 112
"f:\Working\中医\中医装备代码8-20出差回\2023-12-9-SWD&XWTT\Inc\Includes\Encoder.h", "C++", 0, 0, 0, 0, 0, 1, 1
"f:\Working\中医\中医装备代码8-20出差回\2023-12-9-SWD&XWTT\Inc\Includes\MS5637.h", "C++", 62, 0, 0, 0, 40, 37, 139
"f:\Working\中医\中医装备代码8-20出差回\2023-12-9-SWD&XWTT\Inc\Includes\StringTransform.h", "C++", 23, 0, 0, 0, 14, 12, 49
"f:\Working\中医\中医装备代码8-20出差回\2023-12-9-SWD&XWTT\Inc\Includes\ad5722.h", "C++", 110, 0, 0, 0, 26, 14, 150
"f:\Working\中医\中医装备代码8-20出差回\2023-12-9-SWD&XWTT\Inc\Includes\ad9833.h", "C++", 6, 0, 0, 0, 0, 6, 12
"f:\Working\中医\中医装备代码8-20出差回\2023-12-9-SWD&XWTT\Inc\Includes\ade7913.h", "C++", 80, 0, 0, 0, 21, 31, 132
"f:\Working\中医\中医装备代码8-20出差回\2023-12-9-SWD&XWTT\Inc\Includes\com.h", "C++", 56, 0, 0, 0, 42, 17, 115
"f:\Working\中医\中医装备代码8-20出差回\2023-12-9-SWD&XWTT\Inc\Includes\common.h", "C++", 41, 0, 0, 0, 19, 14, 74
"f:\Working\中医\中医装备代码8-20出差回\2023-12-9-SWD&XWTT\Inc\Includes\console.h", "C++", 31, 0, 0, 0, 13, 21, 65
"f:\Working\中医\中医装备代码8-20出差回\2023-12-9-SWD&XWTT\Inc\Includes\crc16.h", "C++", 13, 0, 0, 0, 11, 7, 31
"f:\Working\中医\中医装备代码8-20出差回\2023-12-9-SWD&XWTT\Inc\Includes\dac8831.h", "C++", 38, 0, 0, 0, 17, 13, 68
"f:\Working\中医\中医装备代码8-20出差回\2023-12-9-SWD&XWTT\Inc\Includes\lcdTask.h", "C++", 72, 0, 0, 0, 16, 16, 104
"f:\Working\中医\中医装备代码8-20出差回\2023-12-9-SWD&XWTT\Inc\Includes\motorTask.h", "C++", 55, 0, 0, 0, 33, 26, 114
"f:\Working\中医\中医装备代码8-20出差回\2023-12-9-SWD&XWTT\Inc\Includes\mqttTask.h", "C++", 49, 0, 0, 0, 11, 22, 82
"f:\Working\中医\中医装备代码8-20出差回\2023-12-9-SWD&XWTT\Inc\Includes\myAdc.h", "C++", 33, 0, 0, 0, 15, 19, 67
"f:\Working\中医\中医装备代码8-20出差回\2023-12-9-SWD&XWTT\Inc\Includes\myDac.h", "C++", 7, 0, 0, 0, 10, 4, 21
"f:\Working\中医\中医装备代码8-20出差回\2023-12-9-SWD&XWTT\Inc\Includes\myGpio.h", "C++", 73, 0, 0, 0, 17, 14, 104
"f:\Working\中医\中医装备代码8-20出差回\2023-12-9-SWD&XWTT\Inc\Includes\myI2c.h", "C++", 12, 0, 0, 0, 19, 12, 43
"f:\Working\中医\中医装备代码8-20出差回\2023-12-9-SWD&XWTT\Inc\Includes\mySpi.h", "C++", 37, 0, 0, 0, 19, 19, 75
"f:\Working\中医\中医装备代码8-20出差回\2023-12-9-SWD&XWTT\Inc\Includes\myTimer.h", "C++", 18, 0, 0, 0, 19, 10, 47
"f:\Working\中医\中医装备代码8-20出差回\2023-12-9-SWD&XWTT\Inc\Includes\myUart.h", "C++", 32, 0, 0, 0, 18, 16, 66
"f:\Working\中医\中医装备代码8-20出差回\2023-12-9-SWD&XWTT\Inc\Includes\parameter.h", "C++", 325, 0, 0, 0, 43, 90, 458
"f:\Working\中医\中医装备代码8-20出差回\2023-12-9-SWD&XWTT\Inc\Includes\pca9554.h", "C++", 20, 0, 0, 0, 6, 9, 35
"f:\Working\中医\中医装备代码8-20出差回\2023-12-9-SWD&XWTT\Inc\Includes\spiFlash.h", "C++", 35, 0, 0, 0, 13, 17, 65
"f:\Working\中医\中医装备代码8-20出差回\2023-12-9-SWD&XWTT\Inc\Includes\startDefaultTask.h", "C++", 18, 0, 0, 0, 17, 10, 45
"f:\Working\中医\中医装备代码8-20出差回\2023-12-9-SWD&XWTT\Inc\Includes\startLoopTask.h", "C++", 14, 0, 0, 0, 16, 6, 36
"f:\Working\中医\中医装备代码8-20出差回\2023-12-9-SWD&XWTT\Inc\Includes\startTask1.h", "C++", 56, 0, 0, 0, 27, 20, 103
"f:\Working\中医\中医装备代码8-20出差回\2023-12-9-SWD&XWTT\Inc\Includes\stepMotor.h", "C++", 13, 0, 0, 0, 27, 15, 55
"f:\Working\中医\中医装备代码8-20出差回\2023-12-9-SWD&XWTT\Inc\Includes\tpl0401.h", "C++", 19, 0, 0, 0, 15, 8, 42
"f:\Working\中医\中医装备代码8-20出差回\2023-12-9-SWD&XWTT\Inc\ethernetif.h", "C++", 11, 0, 0, 0, 25, 12, 48
"f:\Working\中医\中医装备代码8-20出差回\2023-12-9-SWD&XWTT\Inc\lwip.h", "C++", 25, 0, 0, 0, 40, 13, 78
"f:\Working\中医\中医装备代码8-20出差回\2023-12-9-SWD&XWTT\Inc\lwipopts.h", "C++", 42, 0, 0, 0, 66, 13, 121
"f:\Working\中医\中医装备代码8-20出差回\2023-12-9-SWD&XWTT\Inc\main.h", "C++", 195, 0, 0, 0, 51, 55, 301
"f:\Working\中医\中医装备代码8-20出差回\2023-12-9-SWD&XWTT\Inc\stm32h7xx_hal_conf.h", "C++", 265, 0, 0, 0, 113, 79, 457
"f:\Working\中医\中医装备代码8-20出差回\2023-12-9-SWD&XWTT\Inc\stm32h7xx_it.h", "C++", 34, 0, 0, 0, 36, 21, 91
"f:\Working\中医\中医装备代码8-20出差回\2023-12-9-SWD&XWTT\Lwip_App\user_tcp_client.c", "C", 0, 1401, 0, 0, 186, 132, 1719
"f:\Working\中医\中医装备代码8-20出差回\2023-12-9-SWD&XWTT\Lwip_App\user_tcp_client.h", "C++", 41, 0, 0, 0, 2, 18, 61
"f:\Working\中医\中医装备代码8-20出差回\2023-12-9-SWD&XWTT\Lwip_App\user_tcp_com.h", "C++", 13, 0, 0, 0, 1, 4, 18
"f:\Working\中医\中医装备代码8-20出差回\2023-12-9-SWD&XWTT\Lwip_App\user_tcp_server.c", "C", 0, 72, 0, 0, 16, 4, 92
"f:\Working\中医\中医装备代码8-20出差回\2023-12-9-SWD&XWTT\Lwip_App\user_tcp_server.h", "C++", 5, 0, 0, 0, 0, 3, 8
"f:\Working\中医\中医装备代码8-20出差回\2023-12-9-SWD&XWTT\Lwip_App\user_udp_server.c", "C", 0, 39, 0, 0, 2, 4, 45
"f:\Working\中医\中医装备代码8-20出差回\2023-12-9-SWD&XWTT\Lwip_App\user_udp_server.h", "C++", 4, 0, 0, 0, 0, 3, 7
"f:\Working\中医\中医装备代码8-20出差回\2023-12-9-SWD&XWTT\MDK-ARM\JLinkSettings.ini", "Ini", 0, 0, 39, 0, 0, 1, 40
"f:\Working\中医\中医装备代码8-20出差回\2023-12-9-SWD&XWTT\MDK-ARM\RTE\_motorDriver\RTE_Components.h", "C++", 4, 0, 0, 0, 10, 8, 22
"f:\Working\中医\中医装备代码8-20出差回\2023-12-9-SWD&XWTT\MDK-ARM\motorDriver\motorDriver.build_log.htm", "HTML", 0, 0, 0, 63, 0, 10, 73
"f:\Working\中医\中医装备代码8-20出差回\2023-12-9-SWD&XWTT\MDK-ARM\motorDriver\motorDriver.htm", "HTML", 0, 0, 0, 8826, 0, 842, 9668
"f:\Working\中医\中医装备代码8-20出差回\2023-12-9-SWD&XWTT\Middlewares\Third_Party\FreeRTOS\Source\CMSIS_RTOS\cmsis_os.c", "C", 0, 1051, 0, 0, 448, 229, 1728
"f:\Working\中医\中医装备代码8-20出差回\2023-12-9-SWD&XWTT\Middlewares\Third_Party\FreeRTOS\Source\CMSIS_RTOS\cmsis_os.h", "C++", 331, 0, 0, 0, 533, 163, 1027
"f:\Working\中医\中医装备代码8-20出差回\2023-12-9-SWD&XWTT\Middlewares\Third_Party\FreeRTOS\Source\croutine.c", "C", 0, 179, 0, 0, 117, 58, 354
"f:\Working\中医\中医装备代码8-20出差回\2023-12-9-SWD&XWTT\Middlewares\Third_Party\FreeRTOS\Source\event_groups.c", "C", 0, 457, 0, 0, 166, 116, 739
"f:\Working\中医\中医装备代码8-20出差回\2023-12-9-SWD&XWTT\Middlewares\Third_Party\FreeRTOS\Source\include\FreeRTOS.h", "C++", 741, 0, 0, 0, 202, 226, 1169
"f:\Working\中医\中医装备代码8-20出差回\2023-12-9-SWD&XWTT\Middlewares\Third_Party\FreeRTOS\Source\include\FreeRTOSConfig_template.h", "C++", 55, 0, 0, 0, 88, 20, 163
"f:\Working\中医\中医装备代码8-20出差回\2023-12-9-SWD&XWTT\Middlewares\Third_Party\FreeRTOS\Source\include\StackMacros.h", "C++", 65, 0, 0, 0, 47, 22, 134
"f:\Working\中医\中医装备代码8-20出差回\2023-12-9-SWD&XWTT\Middlewares\Third_Party\FreeRTOS\Source\include\croutine.h", "C++", 68, 0, 0, 0, 629, 24, 721
"f:\Working\中医\中医装备代码8-20出差回\2023-12-9-SWD&XWTT\Middlewares\Third_Party\FreeRTOS\Source\include\deprecated_definitions.h", "C++", 180, 0, 0, 0, 38, 62, 280
"f:\Working\中医\中医装备代码8-20出差回\2023-12-9-SWD&XWTT\Middlewares\Third_Party\FreeRTOS\Source\include\event_groups.h", "C++", 44, 0, 0, 0, 684, 29, 757
"f:\Working\中医\中医装备代码8-20出差回\2023-12-9-SWD&XWTT\Middlewares\Third_Party\FreeRTOS\Source\include\list.h", "C++", 96, 0, 0, 0, 279, 37, 412
"f:\Working\中医\中医装备代码8-20出差回\2023-12-9-SWD&XWTT\Middlewares\Third_Party\FreeRTOS\Source\include\message_buffer.h", "C++", 24, 0, 0, 0, 731, 25, 780
"f:\Working\中医\中医装备代码8-20出差回\2023-12-9-SWD&XWTT\Middlewares\Third_Party\FreeRTOS\Source\include\mpu_prototypes.h", "C++", 105, 0, 0, 0, 38, 13, 156
"f:\Working\中医\中医装备代码8-20出差回\2023-12-9-SWD&XWTT\Middlewares\Third_Party\FreeRTOS\Source\include\mpu_wrappers.h", "C++", 111, 0, 0, 0, 48, 23, 182
"f:\Working\中医\中医装备代码8-20出差回\2023-12-9-SWD&XWTT\Middlewares\Third_Party\FreeRTOS\Source\include\portable.h", "C++", 60, 0, 0, 0, 80, 26, 166
"f:\Working\中医\中医装备代码8-20出差回\2023-12-9-SWD&XWTT\Middlewares\Third_Party\FreeRTOS\Source\include\projdefs.h", "C++", 68, 0, 0, 0, 40, 17, 125
"f:\Working\中医\中医装备代码8-20出差回\2023-12-9-SWD&XWTT\Middlewares\Third_Party\FreeRTOS\Source\include\queue.h", "C++", 90, 0, 0, 0, 1512, 52, 1654
"f:\Working\中医\中医装备代码8-20出差回\2023-12-9-SWD&XWTT\Middlewares\Third_Party\FreeRTOS\Source\include\semphr.h", "C++", 59, 0, 0, 0, 1052, 30, 1141
"f:\Working\中医\中医装备代码8-20出差回\2023-12-9-SWD&XWTT\Middlewares\Third_Party\FreeRTOS\Source\include\stack_macros.h", "C++", 62, 0, 0, 0, 47, 21, 130
"f:\Working\中医\中医装备代码8-20出差回\2023-12-9-SWD&XWTT\Middlewares\Third_Party\FreeRTOS\Source\include\stream_buffer.h", "C++", 50, 0, 0, 0, 777, 26, 853
"f:\Working\中医\中医装备代码8-20出差回\2023-12-9-SWD&XWTT\Middlewares\Third_Party\FreeRTOS\Source\include\task.h", "C++", 183, 0, 0, 0, 2058, 98, 2339
"f:\Working\中医\中医装备代码8-20出差回\2023-12-9-SWD&XWTT\Middlewares\Third_Party\FreeRTOS\Source\include\timers.h", "C++", 68, 0, 0, 0, 1170, 40, 1278
"f:\Working\中医\中医装备代码8-20出差回\2023-12-9-SWD&XWTT\Middlewares\Third_Party\FreeRTOS\Source\list.c", "C", 0, 73, 0, 0, 94, 32, 199
"f:\Working\中医\中医装备代码8-20出差回\2023-12-9-SWD&XWTT\Middlewares\Third_Party\FreeRTOS\Source\portable\MemMang\heap_1.c", "C", 0, 66, 0, 0, 57, 25, 148
"f:\Working\中医\中医装备代码8-20出差回\2023-12-9-SWD&XWTT\Middlewares\Third_Party\FreeRTOS\Source\portable\MemMang\heap_2.c", "C", 0, 137, 0, 0, 94, 42, 273
"f:\Working\中医\中医装备代码8-20出差回\2023-12-9-SWD&XWTT\Middlewares\Third_Party\FreeRTOS\Source\portable\MemMang\heap_3.c", "C", 0, 40, 0, 0, 41, 17, 98
"f:\Working\中医\中医装备代码8-20出差回\2023-12-9-SWD&XWTT\Middlewares\Third_Party\FreeRTOS\Source\portable\MemMang\heap_4.c", "C", 0, 247, 0, 0, 131, 59, 437
"f:\Working\中医\中医装备代码8-20出差回\2023-12-9-SWD&XWTT\Middlewares\Third_Party\FreeRTOS\Source\portable\MemMang\heap_5.c", "C", 0, 253, 0, 0, 168, 65, 486
"f:\Working\中医\中医装备代码8-20出差回\2023-12-9-SWD&XWTT\Middlewares\Third_Party\FreeRTOS\Source\portable\RVDS\ARM_CM4F\port.c", "C", 0, 356, 0, 0, 309, 124, 789
"f:\Working\中医\中医装备代码8-20出差回\2023-12-9-SWD&XWTT\Middlewares\Third_Party\FreeRTOS\Source\portable\RVDS\ARM_CM4F\portmacro.h", "C++", 132, 0, 0, 0, 75, 46, 253
"f:\Working\中医\中医装备代码8-20出差回\2023-12-9-SWD&XWTT\Middlewares\Third_Party\FreeRTOS\Source\queue.c", "C", 0, 1890, 0, 0, 631, 388, 2909
"f:\Working\中医\中医装备代码8-20出差回\2023-12-9-SWD&XWTT\Middlewares\Third_Party\FreeRTOS\Source\stream_buffer.c", "C", 0, 788, 0, 0, 242, 170, 1200
"f:\Working\中医\中医装备代码8-20出差回\2023-12-9-SWD&XWTT\Middlewares\Third_Party\FreeRTOS\Source\tasks.c", "C", 0, 3043, 0, 0, 1266, 731, 5040
"f:\Working\中医\中医装备代码8-20出差回\2023-12-9-SWD&XWTT\Middlewares\Third_Party\FreeRTOS\Source\timers.c", "C", 0, 637, 0, 0, 279, 161, 1077
"f:\Working\中医\中医装备代码8-20出差回\2023-12-9-SWD&XWTT\Middlewares\Third_Party\LwIP\src\api\api_lib.c", "C", 0, 604, 0, 0, 303, 104, 1011
"f:\Working\中医\中医装备代码8-20出差回\2023-12-9-SWD&XWTT\Middlewares\Third_Party\LwIP\src\api\api_msg.c", "C", 0, 1408, 0, 0, 408, 138, 1954
"f:\Working\中医\中医装备代码8-20出差回\2023-12-9-SWD&XWTT\Middlewares\Third_Party\LwIP\src\api\err.c", "C", 0, 62, 0, 0, 44, 10, 116
"f:\Working\中医\中医装备代码8-20出差回\2023-12-9-SWD&XWTT\Middlewares\Third_Party\LwIP\src\api\netbuf.c", "C", 0, 110, 0, 0, 118, 19, 247
"f:\Working\中医\中医装备代码8-20出差回\2023-12-9-SWD&XWTT\Middlewares\Third_Party\LwIP\src\api\netdb.c", "C", 0, 253, 0, 0, 123, 38, 414
"f:\Working\中医\中医装备代码8-20出差回\2023-12-9-SWD&XWTT\Middlewares\Third_Party\LwIP\src\api\netifapi.c", "C", 0, 127, 0, 0, 74, 21, 222
"f:\Working\中医\中医装备代码8-20出差回\2023-12-9-SWD&XWTT\Middlewares\Third_Party\LwIP\src\api\sockets.c", "C", 0, 2207, 0, 0, 352, 269, 2828
"f:\Working\中医\中医装备代码8-20出差回\2023-12-9-SWD&XWTT\Middlewares\Third_Party\LwIP\src\api\tcpip.c", "C", 0, 300, 0, 0, 165, 54, 519
"f:\Working\中医\中医装备代码8-20出差回\2023-12-9-SWD&XWTT\Middlewares\Third_Party\LwIP\src\apps\mqtt\mqtt.c", "C", 0, 823, 0, 0, 357, 163, 1343
"f:\Working\中医\中医装备代码8-20出差回\2023-12-9-SWD&XWTT\Middlewares\Third_Party\LwIP\src\core\def.c", "C", 0, 106, 0, 0, 101, 16, 223
"f:\Working\中医\中医装备代码8-20出差回\2023-12-9-SWD&XWTT\Middlewares\Third_Party\LwIP\src\core\dns.c", "C", 0, 1055, 0, 0, 397, 122, 1574
"f:\Working\中医\中医装备代码8-20出差回\2023-12-9-SWD&XWTT\Middlewares\Third_Party\LwIP\src\core\inet_chksum.c", "C", 0, 328, 0, 0, 219, 63, 610
"f:\Working\中医\中医装备代码8-20出差回\2023-12-9-SWD&XWTT\Middlewares\Third_Party\LwIP\src\core\init.c", "C", 0, 319, 0, 0, 50, 17, 386
"f:\Working\中医\中医装备代码8-20出差回\2023-12-9-SWD&XWTT\Middlewares\Third_Party\LwIP\src\core\ip.c", "C", 0, 42, 0, 0, 71, 12, 125
"f:\Working\中医\中医装备代码8-20出差回\2023-12-9-SWD&XWTT\Middlewares\Third_Party\LwIP\src\core\ipv4\autoip.c", "C", 0, 282, 0, 0, 190, 56, 528
"f:\Working\中医\中医装备代码8-20出差回\2023-12-9-SWD&XWTT\Middlewares\Third_Party\LwIP\src\core\ipv4\dhcp.c", "C", 0, 1288, 0, 0, 484, 180, 1952
"f:\Working\中医\中医装备代码8-20出差回\2023-12-9-SWD&XWTT\Middlewares\Third_Party\LwIP\src\core\ipv4\etharp.c", "C", 0, 671, 0, 0, 442, 94, 1207
"f:\Working\中医\中医装备代码8-20出差回\2023-12-9-SWD&XWTT\Middlewares\Third_Party\LwIP\src\core\ipv4\icmp.c", "C", 0, 265, 0, 0, 104, 29, 398
"f:\Working\中医\中医装备代码8-20出差回\2023-12-9-SWD&XWTT\Middlewares\Third_Party\LwIP\src\core\ipv4\igmp.c", "C", 0, 436, 0, 0, 264, 101, 801
"f:\Working\中医\中医装备代码8-20出差回\2023-12-9-SWD&XWTT\Middlewares\Third_Party\LwIP\src\core\ipv4\ip4.c", "C", 0, 730, 0, 0, 266, 91, 1087
"f:\Working\中医\中医装备代码8-20出差回\2023-12-9-SWD&XWTT\Middlewares\Third_Party\LwIP\src\core\ipv4\ip4_addr.c", "C", 0, 192, 0, 0, 115, 25, 332
"f:\Working\中医\中医装备代码8-20出差回\2023-12-9-SWD&XWTT\Middlewares\Third_Party\LwIP\src\core\ipv4\ip4_frag.c", "C", 0, 537, 0, 0, 253, 75, 865
"f:\Working\中医\中医装备代码8-20出差回\2023-12-9-SWD&XWTT\Middlewares\Third_Party\LwIP\src\core\ipv6\dhcp6.c", "C", 0, 5, 0, 0, 39, 7, 51
"f:\Working\中医\中医装备代码8-20出差回\2023-12-9-SWD&XWTT\Middlewares\Third_Party\LwIP\src\core\ipv6\ethip6.c", "C", 0, 39, 0, 0, 66, 14, 119
"f:\Working\中医\中医装备代码8-20出差回\2023-12-9-SWD&XWTT\Middlewares\Third_Party\LwIP\src\core\ipv6\icmp6.c", "C", 0, 203, 0, 0, 112, 36, 351
"f:\Working\中医\中医装备代码8-20出差回\2023-12-9-SWD&XWTT\Middlewares\Third_Party\LwIP\src\core\ipv6\inet6.c", "C", 0, 6, 0, 0, 41, 7, 54
"f:\Working\中医\中医装备代码8-20出差回\2023-12-9-SWD&XWTT\Middlewares\Third_Party\LwIP\src\core\ipv6\ip6.c", "C", 0, 737, 0, 0, 279, 107, 1123
"f:\Working\中医\中医装备代码8-20出差回\2023-12-9-SWD&XWTT\Middlewares\Third_Party\LwIP\src\core\ipv6\ip6_addr.c", "C", 0, 180, 0, 0, 86, 27, 293
"f:\Working\中医\中医装备代码8-20出差回\2023-12-9-SWD&XWTT\Middlewares\Third_Party\LwIP\src\core\ipv6\ip6_frag.c", "C", 0, 517, 0, 0, 205, 84, 806
"f:\Working\中医\中医装备代码8-20出差回\2023-12-9-SWD&XWTT\Middlewares\Third_Party\LwIP\src\core\ipv6\mld6.c", "C", 0, 314, 0, 0, 198, 77, 589
"f:\Working\中医\中医装备代码8-20出差回\2023-12-9-SWD&XWTT\Middlewares\Third_Party\LwIP\src\core\ipv6\nd6.c", "C", 0, 1357, 0, 0, 516, 230, 2103
"f:\Working\中医\中医装备代码8-20出差回\2023-12-9-SWD&XWTT\Middlewares\Third_Party\LwIP\src\core\mem.c", "C", 0, 432, 0, 0, 266, 80, 778
"f:\Working\中医\中医装备代码8-20出差回\2023-12-9-SWD&XWTT\Middlewares\Third_Party\LwIP\src\core\memp.c", "C", 0, 327, 0, 0, 115, 55, 497
"f:\Working\中医\中医装备代码8-20出差回\2023-12-9-SWD&XWTT\Middlewares\Third_Party\LwIP\src\core\netif.c", "C", 0, 811, 0, 0, 337, 121, 1269
"f:\Working\中医\中医装备代码8-20出差回\2023-12-9-SWD&XWTT\Middlewares\Third_Party\LwIP\src\core\pbuf.c", "C", 0, 737, 0, 0, 608, 98, 1443
"f:\Working\中医\中医装备代码8-20出差回\2023-12-9-SWD&XWTT\Middlewares\Third_Party\LwIP\src\core\raw.c", "C", 0, 277, 0, 0, 206, 39, 522
"f:\Working\中医\中医装备代码8-20出差回\2023-12-9-SWD&XWTT\Middlewares\Third_Party\LwIP\src\core\stats.c", "C", 0, 117, 0, 0, 36, 17, 170
"f:\Working\中医\中医装备代码8-20出差回\2023-12-9-SWD&XWTT\Middlewares\Third_Party\LwIP\src\core\sys.c", "C", 0, 18, 0, 0, 80, 9, 107
"f:\Working\中医\中医装备代码8-20出差回\2023-12-9-SWD&XWTT\Middlewares\Third_Party\LwIP\src\core\tcp.c", "C", 0, 1398, 0, 0, 607, 167, 2172
"f:\Working\中医\中医装备代码8-20出差回\2023-12-9-SWD&XWTT\Middlewares\Third_Party\LwIP\src\core\tcp_in.c", "C", 0, 1205, 0, 0, 501, 132, 1838
"f:\Working\中医\中医装备代码8-20出差回\2023-12-9-SWD&XWTT\Middlewares\Third_Party\LwIP\src\core\tcp_out.c", "C", 0, 1079, 0, 0, 441, 152, 1672
"f:\Working\中医\中医装备代码8-20出差回\2023-12-9-SWD&XWTT\Middlewares\Third_Party\LwIP\src\core\timeouts.c", "C", 0, 270, 0, 0, 128, 36, 434
"f:\Working\中医\中医装备代码8-20出差回\2023-12-9-SWD&XWTT\Middlewares\Third_Party\LwIP\src\core\udp.c", "C", 0, 734, 0, 0, 366, 92, 1192
"f:\Working\中医\中医装备代码8-20出差回\2023-12-9-SWD&XWTT\Middlewares\Third_Party\LwIP\src\include\lwip\api.h", "C++", 217, 0, 0, 0, 148, 36, 401
"f:\Working\中医\中医装备代码8-20出差回\2023-12-9-SWD&XWTT\Middlewares\Third_Party\LwIP\src\include\lwip\apps\fs.h", "C++", 59, 0, 0, 0, 33, 12, 104
"f:\Working\中医\中医装备代码8-20出差回\2023-12-9-SWD&XWTT\Middlewares\Third_Party\LwIP\src\include\lwip\apps\httpd.h", "C++", 61, 0, 0, 0, 147, 29, 237
"f:\Working\中医\中医装备代码8-20出差回\2023-12-9-SWD&XWTT\Middlewares\Third_Party\LwIP\src\include\lwip\apps\httpd_opts.h", "C++", 134, 0, 0, 0, 140, 49, 323
"f:\Working\中医\中医装备代码8-20出差回\2023-12-9-SWD&XWTT\Middlewares\Third_Party\LwIP\src\include\lwip\apps\lwiperf.h", "C++", 28, 0, 0, 0, 45, 12, 85
"f:\Working\中医\中医装备代码8-20出差回\2023-12-9-SWD&XWTT\Middlewares\Third_Party\LwIP\src\include\lwip\apps\mdns.h", "C++", 21, 0, 0, 0, 36, 13, 70
"f:\Working\中医\中医装备代码8-20出差回\2023-12-9-SWD&XWTT\Middlewares\Third_Party\LwIP\src\include\lwip\apps\mdns_opts.h", "C++", 13, 0, 0, 0, 51, 11, 75
"f:\Working\中医\中医装备代码8-20出差回\2023-12-9-SWD&XWTT\Middlewares\Third_Party\LwIP\src\include\lwip\apps\mdns_priv.h", "C++", 18, 0, 0, 0, 39, 10, 67
"f:\Working\中医\中医装备代码8-20出差回\2023-12-9-SWD&XWTT\Middlewares\Third_Party\LwIP\src\include\lwip\apps\mqtt.h", "C++", 87, 0, 0, 0, 125, 33, 245
"f:\Working\中医\中医装备代码8-20出差回\2023-12-9-SWD&XWTT\Middlewares\Third_Party\LwIP\src\include\lwip\apps\mqtt_opts.h", "C++", 28, 0, 0, 0, 62, 14, 104
"f:\Working\中医\中医装备代码8-20出差回\2023-12-9-SWD&XWTT\Middlewares\Third_Party\LwIP\src\include\lwip\apps\netbiosns.h", "C++", 9, 0, 0, 0, 30, 5, 44
"f:\Working\中医\中医装备代码8-20出差回\2023-12-9-SWD&XWTT\Middlewares\Third_Party\LwIP\src\include\lwip\apps\netbiosns_opts.h", "C++", 7, 0, 0, 0, 46, 7, 60
"f:\Working\中医\中医装备代码8-20出差回\2023-12-9-SWD&XWTT\Middlewares\Third_Party\LwIP\src\include\lwip\apps\snmp.h", "C++", 53, 0, 0, 0, 55, 21, 129
"f:\Working\中医\中医装备代码8-20出差回\2023-12-9-SWD&XWTT\Middlewares\Third_Party\LwIP\src\include\lwip\apps\snmp_core.h", "C++", 232, 0, 0, 0, 77, 56, 365
"f:\Working\中医\中医装备代码8-20出差回\2023-12-9-SWD&XWTT\Middlewares\Third_Party\LwIP\src\include\lwip\apps\snmp_mib2.h", "C++", 31, 0, 0, 0, 35, 13, 79
"f:\Working\中医\中医装备代码8-20出差回\2023-12-9-SWD&XWTT\Middlewares\Third_Party\LwIP\src\include\lwip\apps\snmp_opts.h", "C++", 93, 0, 0, 0, 166, 35, 294
"f:\Working\中医\中医装备代码8-20出差回\2023-12-9-SWD&XWTT\Middlewares\Third_Party\LwIP\src\include\lwip\apps\snmp_scalar.h", "C++", 55, 0, 0, 0, 40, 19, 114
"f:\Working\中医\中医装备代码8-20出差回\2023-12-9-SWD&XWTT\Middlewares\Third_Party\LwIP\src\include\lwip\apps\snmp_table.h", "C++", 70, 0, 0, 0, 44, 21, 135
"f:\Working\中医\中医装备代码8-20出差回\2023-12-9-SWD&XWTT\Middlewares\Third_Party\LwIP\src\include\lwip\apps\snmp_threadsync.h", "C++", 55, 0, 0, 0, 41, 19, 115
"f:\Working\中医\中医装备代码8-20出差回\2023-12-9-SWD&XWTT\Middlewares\Third_Party\LwIP\src\include\lwip\apps\snmpv3.h", "C++", 35, 0, 0, 0, 37, 19, 91
"f:\Working\中医\中医装备代码8-20出差回\2023-12-9-SWD&XWTT\Middlewares\Third_Party\LwIP\src\include\lwip\apps\sntp.h", "C++", 29, 0, 0, 0, 37, 11, 77
"f:\Working\中医\中医装备代码8-20出差回\2023-12-9-SWD&XWTT\Middlewares\Third_Party\LwIP\src\include\lwip\apps\sntp_opts.h", "C++", 52, 0, 0, 0, 100, 22, 174
"f:\Working\中医\中医装备代码8-20出差回\2023-12-9-SWD&XWTT\Middlewares\Third_Party\LwIP\src\include\lwip\apps\tftp_opts.h", "C++", 26, 0, 0, 0, 66, 14, 106
"f:\Working\中医\中医装备代码8-20出差回\2023-12-9-SWD&XWTT\Middlewares\Third_Party\LwIP\src\include\lwip\apps\tftp_server.h", "C++", 20, 0, 0, 0, 66, 9, 95
"f:\Working\中医\中医装备代码8-20出差回\2023-12-9-SWD&XWTT\Middlewares\Third_Party\LwIP\src\include\lwip\arch.h", "C++", 137, 0, 0, 0, 146, 37, 320
"f:\Working\中医\中医装备代码8-20出差回\2023-12-9-SWD&XWTT\Middlewares\Third_Party\LwIP\src\include\lwip\autoip.h", "C++", 35, 0, 0, 0, 49, 16, 100
"f:\Working\中医\中医装备代码8-20出差回\2023-12-9-SWD&XWTT\Middlewares\Third_Party\LwIP\src\include\lwip\debug.h", "C++", 63, 0, 0, 0, 88, 17, 168
"f:\Working\中医\中医装备代码8-20出差回\2023-12-9-SWD&XWTT\Middlewares\Third_Party\LwIP\src\include\lwip\def.h", "C++", 75, 0, 0, 0, 51, 16, 142
"f:\Working\中医\中医装备代码8-20出差回\2023-12-9-SWD&XWTT\Middlewares\Third_Party\LwIP\src\include\lwip\dhcp.h", "C++", 74, 0, 0, 0, 51, 19, 144
"f:\Working\中医\中医装备代码8-20出差回\2023-12-9-SWD&XWTT\Middlewares\Third_Party\LwIP\src\include\lwip\dhcp6.h", "C++", 9, 0, 0, 0, 41, 9, 59
"f:\Working\中医\中医装备代码8-20出差回\2023-12-9-SWD&XWTT\Middlewares\Third_Party\LwIP\src\include\lwip\dns.h", "C++", 65, 0, 0, 0, 48, 18, 131
"f:\Working\中医\中医装备代码8-20出差回\2023-12-9-SWD&XWTT\Middlewares\Third_Party\LwIP\src\include\lwip\err.h", "C++", 44, 0, 0, 0, 63, 13, 120
"f:\Working\中医\中医装备代码8-20出差回\2023-12-9-SWD&XWTT\Middlewares\Third_Party\LwIP\src\include\lwip\errno.h", "C++", 143, 0, 0, 0, 36, 15, 194
"f:\Working\中医\中医装备代码8-20出差回\2023-12-9-SWD&XWTT\Middlewares\Third_Party\LwIP\src\include\lwip\etharp.h", "C++", 42, 0, 0, 0, 47, 18, 107
"f:\Working\中医\中医装备代码8-20出差回\2023-12-9-SWD&XWTT\Middlewares\Third_Party\LwIP\src\include\lwip\ethip6.h", "C++", 17, 0, 0, 0, 39, 13, 69
"f:\Working\中医\中医装备代码8-20出差回\2023-12-9-SWD&XWTT\Middlewares\Third_Party\LwIP\src\include\lwip\icmp.h", "C++", 53, 0, 0, 0, 45, 13, 111
"f:\Working\中医\中医装备代码8-20出差回\2023-12-9-SWD&XWTT\Middlewares\Third_Party\LwIP\src\include\lwip\icmp6.h", "C++", 21, 0, 0, 0, 39, 11, 71
"f:\Working\中医\中医装备代码8-20出差回\2023-12-9-SWD&XWTT\Middlewares\Third_Party\LwIP\src\include\lwip\igmp.h", "C++", 40, 0, 0, 0, 62, 14, 116
"f:\Working\中医\中医装备代码8-20出差回\2023-12-9-SWD&XWTT\Middlewares\Third_Party\LwIP\src\include\lwip\inet.h", "C++", 88, 0, 0, 0, 57, 28, 173
"f:\Working\中医\中医装备代码8-20出差回\2023-12-9-SWD&XWTT\Middlewares\Third_Party\LwIP\src\include\lwip\inet_chksum.h", "C++", 51, 0, 0, 0, 39, 16, 106
"f:\Working\中医\中医装备代码8-20出差回\2023-12-9-SWD&XWTT\Middlewares\Third_Party\LwIP\src\include\lwip\init.h", "C++", 32, 0, 0, 0, 55, 14, 101
"f:\Working\中医\中医装备代码8-20出差回\2023-12-9-SWD&XWTT\Middlewares\Third_Party\LwIP\src\include\lwip\ip.h", "C++", 160, 0, 0, 0, 122, 38, 320
"f:\Working\中医\中医装备代码8-20出差回\2023-12-9-SWD&XWTT\Middlewares\Third_Party\LwIP\src\include\lwip\ip4.h", "C++", 59, 0, 0, 0, 36, 17, 112
"f:\Working\中医\中医装备代码8-20出差回\2023-12-9-SWD&XWTT\Middlewares\Third_Party\LwIP\src\include\lwip\ip4_addr.h", "C++", 114, 0, 0, 0, 80, 34, 228
"f:\Working\中医\中医装备代码8-20出差回\2023-12-9-SWD&XWTT\Middlewares\Third_Party\LwIP\src\include\lwip\ip4_frag.h", "C++", 43, 0, 0, 0, 44, 14, 101
"f:\Working\中医\中医装备代码8-20出差回\2023-12-9-SWD&XWTT\Middlewares\Third_Party\LwIP\src\include\lwip\ip6.h", "C++", 41, 0, 0, 0, 39, 14, 94
"f:\Working\中医\中医装备代码8-20出差回\2023-12-9-SWD&XWTT\Middlewares\Third_Party\LwIP\src\include\lwip\ip6_addr.h", "C++", 171, 0, 0, 0, 71, 44, 286
"f:\Working\中医\中医装备代码8-20出差回\2023-12-9-SWD&XWTT\Middlewares\Third_Party\LwIP\src\include\lwip\ip6_frag.h", "C++", 49, 0, 0, 0, 53, 19, 121
"f:\Working\中医\中医装备代码8-20出差回\2023-12-9-SWD&XWTT\Middlewares\Third_Party\LwIP\src\include\lwip\ip_addr.h", "C++", 234, 0, 0, 0, 128, 46, 408
"f:\Working\中医\中医装备代码8-20出差回\2023-12-9-SWD&XWTT\Middlewares\Third_Party\LwIP\src\include\lwip\mem.h", "C++", 31, 0, 0, 0, 38, 14, 83
"f:\Working\中医\中医装备代码8-20出差回\2023-12-9-SWD&XWTT\Middlewares\Third_Party\LwIP\src\include\lwip\memp.h", "C++", 66, 0, 0, 0, 69, 21, 156
"f:\Working\中医\中医装备代码8-20出差回\2023-12-9-SWD&XWTT\Middlewares\Third_Party\LwIP\src\include\lwip\mld6.h", "C++", 33, 0, 0, 0, 53, 14, 100
"f:\Working\中医\中医装备代码8-20出差回\2023-12-9-SWD&XWTT\Middlewares\Third_Party\LwIP\src\include\lwip\nd6.h", "C++", 30, 0, 0, 0, 42, 13, 85
"f:\Working\中医\中医装备代码8-20出差回\2023-12-9-SWD&XWTT\Middlewares\Third_Party\LwIP\src\include\lwip\netbuf.h", "C++", 63, 0, 0, 0, 41, 15, 119
"f:\Working\中医\中医装备代码8-20出差回\2023-12-9-SWD&XWTT\Middlewares\Third_Party\LwIP\src\include\lwip\netdb.h", "C++", 87, 0, 0, 0, 42, 22, 151
"f:\Working\中医\中医装备代码8-20出差回\2023-12-9-SWD&XWTT\Middlewares\Third_Party\LwIP\src\include\lwip\netif.h", "C++", 246, 0, 0, 0, 185, 44, 475
"f:\Working\中医\中医装备代码8-20出差回\2023-12-9-SWD&XWTT\Middlewares\Third_Party\LwIP\src\include\lwip\netifapi.h", "C++", 68, 0, 0, 0, 54, 19, 141
"f:\Working\中医\中医装备代码8-20出差回\2023-12-9-SWD&XWTT\Middlewares\Third_Party\LwIP\src\include\lwip\opt.h", "C++", 894, 0, 0, 0, 1691, 292, 2877
"f:\Working\中医\中医装备代码8-20出差回\2023-12-9-SWD&XWTT\Middlewares\Third_Party\LwIP\src\include\lwip\pbuf.h", "C++", 106, 0, 0, 0, 128, 30, 264
"f:\Working\中医\中医装备代码8-20出差回\2023-12-9-SWD&XWTT\Middlewares\Third_Party\LwIP\src\include\lwip\priv\api_msg.h", "C++", 132, 0, 0, 0, 66, 19, 217
"f:\Working\中医\中医装备代码8-20出差回\2023-12-9-SWD&XWTT\Middlewares\Third_Party\LwIP\src\include\lwip\priv\memp_priv.h", "C++", 97, 0, 0, 0, 62, 25, 184
"f:\Working\中医\中医装备代码8-20出差回\2023-12-9-SWD&XWTT\Middlewares\Third_Party\LwIP\src\include\lwip\priv\memp_std.h", "C++", 81, 0, 0, 0, 44, 22, 147
"f:\Working\中医\中医装备代码8-20出差回\2023-12-9-SWD&XWTT\Middlewares\Third_Party\LwIP\src\include\lwip\priv\nd6_priv.h", "C++", 75, 0, 0, 0, 51, 19, 145
"f:\Working\中医\中医装备代码8-20出差回\2023-12-9-SWD&XWTT\Middlewares\Third_Party\LwIP\src\include\lwip\priv\tcp_priv.h", "C++", 352, 0, 0, 0, 82, 74, 508
"f:\Working\中医\中医装备代码8-20出差回\2023-12-9-SWD&XWTT\Middlewares\Third_Party\LwIP\src\include\lwip\priv\tcpip_priv.h", "C++", 111, 0, 0, 0, 35, 15, 161
"f:\Working\中医\中医装备代码8-20出差回\2023-12-9-SWD&XWTT\Middlewares\Third_Party\LwIP\src\include\lwip\prot\autoip.h", "C++", 28, 0, 0, 0, 42, 9, 79
"f:\Working\中医\中医装备代码8-20出差回\2023-12-9-SWD&XWTT\Middlewares\Third_Party\LwIP\src\include\lwip\prot\dhcp.h", "C++", 110, 0, 0, 0, 49, 25, 184
"f:\Working\中医\中医装备代码8-20出差回\2023-12-9-SWD&XWTT\Middlewares\Third_Party\LwIP\src\include\lwip\prot\dns.h", "C++", 77, 0, 0, 0, 46, 18, 141
"f:\Working\中医\中医装备代码8-20出差回\2023-12-9-SWD&XWTT\Middlewares\Third_Party\LwIP\src\include\lwip\prot\etharp.h", "C++", 42, 0, 0, 0, 39, 11, 92
"f:\Working\中医\中医装备代码8-20出差回\2023-12-9-SWD&XWTT\Middlewares\Third_Party\LwIP\src\include\lwip\prot\ethernet.h", "C++", 89, 0, 0, 0, 64, 18, 171
"f:\Working\中医\中医装备代码8-20出差回\2023-12-9-SWD&XWTT\Middlewares\Third_Party\LwIP\src\include\lwip\prot\icmp.h", "C++", 42, 0, 0, 0, 41, 9, 92
"f:\Working\中医\中医装备代码8-20出差回\2023-12-9-SWD&XWTT\Middlewares\Third_Party\LwIP\src\include\lwip\prot\icmp6.h", "C++", 82, 0, 0, 0, 76, 13, 171
"f:\Working\中医\中医装备代码8-20出差回\2023-12-9-SWD&XWTT\Middlewares\Third_Party\LwIP\src\include\lwip\prot\igmp.h", "C++", 36, 0, 0, 0, 45, 10, 91
"f:\Working\中医\中医装备代码8-20出差回\2023-12-9-SWD&XWTT\Middlewares\Third_Party\LwIP\src\include\lwip\prot\ip.h", "C++", 10, 0, 0, 0, 36, 6, 52
"f:\Working\中医\中医装备代码8-20出差回\2023-12-9-SWD&XWTT\Middlewares\Third_Party\LwIP\src\include\lwip\prot\ip4.h", "C++", 65, 0, 0, 0, 50, 13, 128
"f:\Working\中医\中医装备代码8-20出差回\2023-12-9-SWD&XWTT\Middlewares\Third_Party\LwIP\src\include\lwip\prot\ip6.h", "C++", 100, 0, 0, 0, 56, 14, 170
"f:\Working\中医\中医装备代码8-20出差回\2023-12-9-SWD&XWTT\Middlewares\Third_Party\LwIP\src\include\lwip\prot\mld6.h", "C++", 27, 0, 0, 0, 37, 7, 71
"f:\Working\中医\中医装备代码8-20出差回\2023-12-9-SWD&XWTT\Middlewares\Third_Party\LwIP\src\include\lwip\prot\nd6.h", "C++", 208, 0, 0, 0, 53, 17, 278
"f:\Working\中医\中医装备代码8-20出差回\2023-12-9-SWD&XWTT\Middlewares\Third_Party\LwIP\src\include\lwip\prot\tcp.h", "C++", 45, 0, 0, 0, 41, 12, 98
"f:\Working\中医\中医装备代码8-20出差回\2023-12-9-SWD&XWTT\Middlewares\Third_Party\LwIP\src\include\lwip\prot\udp.h", "C++", 25, 0, 0, 0, 36, 8, 69
"f:\Working\中医\中医装备代码8-20出差回\2023-12-9-SWD&XWTT\Middlewares\Third_Party\LwIP\src\include\lwip\raw.h", "C++", 43, 0, 0, 0, 55, 21, 119
"f:\Working\中医\中医装备代码8-20出差回\2023-12-9-SWD&XWTT\Middlewares\Third_Party\LwIP\src\include\lwip\sio.h", "C++", 35, 0, 0, 0, 92, 16, 143
"f:\Working\中医\中医装备代码8-20出差回\2023-12-9-SWD&XWTT\Middlewares\Third_Party\LwIP\src\include\lwip\snmp.h", "C++", 120, 0, 0, 0, 72, 22, 214
"f:\Working\中医\中医装备代码8-20出差回\2023-12-9-SWD&XWTT\Middlewares\Third_Party\LwIP\src\include\lwip\sockets.h", "C++", 371, 0, 0, 0, 157, 66, 594
"f:\Working\中医\中医装备代码8-20出差回\2023-12-9-SWD&XWTT\Middlewares\Third_Party\LwIP\src\include\lwip\stats.h", "C++", 349, 0, 0, 0, 101, 42, 492
"f:\Working\中医\中医装备代码8-20出差回\2023-12-9-SWD&XWTT\Middlewares\Third_Party\LwIP\src\include\lwip\sys.h", "C++", 164, 0, 0, 0, 246, 46, 456
"f:\Working\中医\中医装备代码8-20出差回\2023-12-9-SWD&XWTT\Middlewares\Third_Party\LwIP\src\include\lwip\tcp.h", "C++", 230, 0, 0, 0, 136, 68, 434
"f:\Working\中医\中医装备代码8-20出差回\2023-12-9-SWD&XWTT\Middlewares\Third_Party\LwIP\src\include\lwip\tcpip.h", "C++", 42, 0, 0, 0, 46, 19, 107
"f:\Working\中医\中医装备代码8-20出差回\2023-12-9-SWD&XWTT\Middlewares\Third_Party\LwIP\src\include\lwip\timeouts.h", "C++", 57, 0, 0, 0, 47, 18, 122
"f:\Working\中医\中医装备代码8-20出差回\2023-12-9-SWD&XWTT\Middlewares\Third_Party\LwIP\src\include\lwip\udp.h", "C++", 91, 0, 0, 0, 64, 28, 183
"f:\Working\中医\中医装备代码8-20出差回\2023-12-9-SWD&XWTT\Middlewares\Third_Party\LwIP\src\include\netif\etharp.h", "C++", 2, 0, 0, 0, 1, 1, 4
"f:\Working\中医\中医装备代码8-20出差回\2023-12-9-SWD&XWTT\Middlewares\Third_Party\LwIP\src\include\netif\ethernet.h", "C++", 21, 0, 0, 0, 44, 13, 78
"f:\Working\中医\中医装备代码8-20出差回\2023-12-9-SWD&XWTT\Middlewares\Third_Party\LwIP\src\include\netif\lowpan6.h", "C++", 30, 0, 0, 0, 41, 16, 87
"f:\Working\中医\中医装备代码8-20出差回\2023-12-9-SWD&XWTT\Middlewares\Third_Party\LwIP\src\include\netif\lowpan6_opts.h", "C++", 22, 0, 0, 0, 38, 11, 71
"f:\Working\中医\中医装备代码8-20出差回\2023-12-9-SWD&XWTT\Middlewares\Third_Party\LwIP\src\include\netif\ppp\ccp.h", "C++", 78, 0, 0, 0, 53, 26, 157
"f:\Working\中医\中医装备代码8-20出差回\2023-12-9-SWD&XWTT\Middlewares\Third_Party\LwIP\src\include\netif\ppp\chap-md5.h", "C++", 4, 0, 0, 0, 29, 4, 37
"f:\Working\中医\中医装备代码8-20出差回\2023-12-9-SWD&XWTT\Middlewares\Third_Party\LwIP\src\include\netif\ppp\chap-new.h", "C++", 106, 0, 0, 0, 64, 23, 193
"f:\Working\中医\中医装备代码8-20出差回\2023-12-9-SWD&XWTT\Middlewares\Third_Party\LwIP\src\include\netif\ppp\chap_ms.h", "C++", 8, 0, 0, 0, 31, 6, 45
"f:\Working\中医\中医装备代码8-20出差回\2023-12-9-SWD&XWTT\Middlewares\Third_Party\LwIP\src\include\netif\ppp\eap.h", "C++", 111, 0, 0, 0, 35, 24, 170
"f:\Working\中医\中医装备代码8-20出差回\2023-12-9-SWD&XWTT\Middlewares\Third_Party\LwIP\src\include\netif\ppp\ecp.h", "C++", 13, 0, 0, 0, 32, 6, 51
"f:\Working\中医\中医装备代码8-20出差回\2023-12-9-SWD&XWTT\Middlewares\Third_Party\LwIP\src\include\netif\ppp\eui64.h", "C++", 42, 0, 0, 0, 41, 12, 95
"f:\Working\中医\中医装备代码8-20出差回\2023-12-9-SWD&XWTT\Middlewares\Third_Party\LwIP\src\include\netif\ppp\fsm.h", "C++", 89, 0, 0, 0, 66, 21, 176
"f:\Working\中医\中医装备代码8-20出差回\2023-12-9-SWD&XWTT\Middlewares\Third_Party\LwIP\src\include\netif\ppp\ipcp.h", "C++", 65, 0, 0, 0, 48, 14, 127
"f:\Working\中医\中医装备代码8-20出差回\2023-12-9-SWD&XWTT\Middlewares\Third_Party\LwIP\src\include\netif\ppp\ipv6cp.h", "C++", 30, 0, 0, 0, 143, 11, 184
"f:\Working\中医\中医装备代码8-20出差回\2023-12-9-SWD&XWTT\Middlewares\Third_Party\LwIP\src\include\netif\ppp\lcp.h", "C++", 101, 0, 0, 0, 56, 15, 172
"f:\Working\中医\中医装备代码8-20出差回\2023-12-9-SWD&XWTT\Middlewares\Third_Party\LwIP\src\include\netif\ppp\magic.h", "C++", 11, 0, 0, 0, 101, 11, 123
"f:\Working\中医\中医装备代码8-20出差回\2023-12-9-SWD&XWTT\Middlewares\Third_Party\LwIP\src\include\netif\ppp\mppe.h", "C++", 106, 0, 0, 0, 53, 15, 174
"f:\Working\中医\中医装备代码8-20出差回\2023-12-9-SWD&XWTT\Middlewares\Third_Party\LwIP\src\include\netif\ppp\ppp.h", "C++", 365, 0, 0, 0, 246, 80, 691
"f:\Working\中医\中医装备代码8-20出差回\2023-12-9-SWD&XWTT\Middlewares\Third_Party\LwIP\src\include\netif\ppp\ppp_impl.h", "C++", 403, 0, 0, 0, 152, 75, 630
"f:\Working\中医\中医装备代码8-20出差回\2023-12-9-SWD&XWTT\Middlewares\Third_Party\LwIP\src\include\netif\ppp\ppp_opts.h", "C++", 240, 0, 0, 0, 276, 78, 594
"f:\Working\中医\中医装备代码8-20出差回\2023-12-9-SWD&XWTT\Middlewares\Third_Party\LwIP\src\include\netif\ppp\pppapi.h", "C++", 99, 0, 0, 0, 27, 12, 138
"f:\Working\中医\中医装备代码8-20出差回\2023-12-9-SWD&XWTT\Middlewares\Third_Party\LwIP\src\include\netif\ppp\pppcrypt.h", "C++", 73, 0, 0, 0, 42, 22, 137
"f:\Working\中医\中医装备代码8-20出差回\2023-12-9-SWD&XWTT\Middlewares\Third_Party\LwIP\src\include\netif\ppp\pppdebug.h", "C++", 34, 0, 0, 0, 36, 11, 81
"f:\Working\中医\中医装备代码8-20出差回\2023-12-9-SWD&XWTT\Middlewares\Third_Party\LwIP\src\include\netif\ppp\pppoe.h", "C++", 86, 0, 0, 0, 70, 24, 180
"f:\Working\中医\中医装备代码8-20出差回\2023-12-9-SWD&XWTT\Middlewares\Third_Party\LwIP\src\include\netif\ppp\pppol2tp.h", "C++", 102, 0, 0, 0, 63, 37, 202
"f:\Working\中医\中医装备代码8-20出差回\2023-12-9-SWD&XWTT\Middlewares\Third_Party\LwIP\src\include\netif\ppp\pppos.h", "C++", 45, 0, 0, 0, 55, 19, 119
"f:\Working\中医\中医装备代码8-20出差回\2023-12-9-SWD&XWTT\Middlewares\Third_Party\LwIP\src\include\netif\ppp\upap.h", "C++", 46, 0, 0, 0, 61, 17, 124
"f:\Working\中医\中医装备代码8-20出差回\2023-12-9-SWD&XWTT\Middlewares\Third_Party\LwIP\src\include\netif\ppp\vj.h", "C++", 65, 0, 0, 0, 77, 20, 162
"f:\Working\中医\中医装备代码8-20出差回\2023-12-9-SWD&XWTT\Middlewares\Third_Party\LwIP\src\include\netif\slipif.h", "C++", 27, 0, 0, 0, 50, 11, 88
"f:\Working\中医\中医装备代码8-20出差回\2023-12-9-SWD&XWTT\Middlewares\Third_Party\LwIP\src\include\posix\errno.h", "C++", 1, 0, 0, 0, 30, 3, 34
"f:\Working\中医\中医装备代码8-20出差回\2023-12-9-SWD&XWTT\Middlewares\Third_Party\LwIP\src\include\posix\netdb.h", "C++", 1, 0, 0, 0, 30, 3, 34
"f:\Working\中医\中医装备代码8-20出差回\2023-12-9-SWD&XWTT\Middlewares\Third_Party\LwIP\src\include\posix\sys\socket.h", "C++", 1, 0, 0, 0, 30, 3, 34
"f:\Working\中医\中医装备代码8-20出差回\2023-12-9-SWD&XWTT\Middlewares\Third_Party\LwIP\src\netif\ethernet.c", "C", 0, 199, 0, 0, 84, 32, 315
"f:\Working\中医\中医装备代码8-20出差回\2023-12-9-SWD&XWTT\Middlewares\Third_Party\LwIP\src\netif\ethernetif_template.c", "C", 0, 139, 0, 0, 148, 49, 336
"f:\Working\中医\中医装备代码8-20出差回\2023-12-9-SWD&XWTT\Middlewares\Third_Party\LwIP\src\netif\lowpan6.c", "C", 0, 837, 0, 0, 204, 153, 1194
"f:\Working\中医\中医装备代码8-20出差回\2023-12-9-SWD&XWTT\Middlewares\Third_Party\LwIP\src\netif\ppp\auth.c", "C", 0, 1797, 0, 0, 468, 246, 2511
"f:\Working\中医\中医装备代码8-20出差回\2023-12-9-SWD&XWTT\Middlewares\Third_Party\LwIP\src\netif\ppp\ccp.c", "C", 0, 1325, 0, 0, 277, 139, 1741
"f:\Working\中医\中医装备代码8-20出差回\2023-12-9-SWD&XWTT\Middlewares\Third_Party\LwIP\src\netif\ppp\chap-md5.c", "C", 0, 81, 0, 0, 31, 15, 127
"f:\Working\中医\中医装备代码8-20出差回\2023-12-9-SWD&XWTT\Middlewares\Third_Party\LwIP\src\netif\ppp\chap-new.c", "C", 0, 512, 0, 0, 94, 72, 678
"f:\Working\中医\中医装备代码8-20出差回\2023-12-9-SWD&XWTT\Middlewares\Third_Party\LwIP\src\netif\ppp\chap_ms.c", "C", 0, 619, 0, 0, 217, 127, 963
"f:\Working\中医\中医装备代码8-20出差回\2023-12-9-SWD&XWTT\Middlewares\Third_Party\LwIP\src\netif\ppp\demand.c", "C", 0, 336, 0, 0, 83, 47, 466
"f:\Working\中医\中医装备代码8-20出差回\2023-12-9-SWD&XWTT\Middlewares\Third_Party\LwIP\src\netif\ppp\eap.c", "C", 0, 1901, 0, 0, 289, 234, 2424
"f:\Working\中医\中医装备代码8-20出差回\2023-12-9-SWD&XWTT\Middlewares\Third_Party\LwIP\src\netif\ppp\ecp.c", "C", 0, 99, 0, 0, 75, 18, 192
"f:\Working\中医\中医装备代码8-20出差回\2023-12-9-SWD&XWTT\Middlewares\Third_Party\LwIP\src\netif\ppp\eui64.c", "C", 0, 12, 0, 0, 39, 6, 57
"f:\Working\中医\中医装备代码8-20出差回\2023-12-9-SWD&XWTT\Middlewares\Third_Party\LwIP\src\netif\ppp\fsm.c", "C", 0, 527, 0, 0, 164, 109, 800
"f:\Working\中医\中医装备代码8-20出差回\2023-12-9-SWD&XWTT\Middlewares\Third_Party\LwIP\src\netif\ppp\ipcp.c", "C", 0, 1784, 0, 0, 387, 248, 2419
"f:\Working\中医\中医装备代码8-20出差回\2023-12-9-SWD&XWTT\Middlewares\Third_Party\LwIP\src\netif\ppp\ipv6cp.c", "C", 0, 975, 0, 0, 379, 180, 1534
"f:\Working\中医\中医装备代码8-20出差回\2023-12-9-SWD&XWTT\Middlewares\Third_Party\LwIP\src\netif\ppp\lcp.c", "C", 0, 2126, 0, 0, 430, 235, 2791
"f:\Working\中医\中医装备代码8-20出差回\2023-12-9-SWD&XWTT\Middlewares\Third_Party\LwIP\src\netif\ppp\magic.c", "C", 0, 108, 0, 0, 161, 26, 295
"f:\Working\中医\中医装备代码8-20出差回\2023-12-9-SWD&XWTT\Middlewares\Third_Party\LwIP\src\netif\ppp\mppe.c", "C", 0, 242, 0, 0, 118, 53, 413
"f:\Working\中医\中医装备代码8-20出差回\2023-12-9-SWD&XWTT\Middlewares\Third_Party\LwIP\src\netif\ppp\multilink.c", "C", 0, 468, 0, 0, 80, 62, 610
"f:\Working\中医\中医装备代码8-20出差回\2023-12-9-SWD&XWTT\Middlewares\Third_Party\LwIP\src\netif\ppp\ppp.c", "C", 0, 1071, 0, 0, 401, 176, 1648
"f:\Working\中医\中医装备代码8-20出差回\2023-12-9-SWD&XWTT\Middlewares\Third_Party\LwIP\src\netif\ppp\pppapi.c", "C", 0, 250, 0, 0, 121, 57, 428
"f:\Working\中医\中医装备代码8-20出差回\2023-12-9-SWD&XWTT\Middlewares\Third_Party\LwIP\src\netif\ppp\pppcrypt.c", "C", 0, 22, 0, 0, 34, 11, 67
"f:\Working\中医\中医装备代码8-20出差回\2023-12-9-SWD&XWTT\Middlewares\Third_Party\LwIP\src\netif\ppp\pppoe.c", "C", 0, 947, 0, 0, 152, 123, 1222
"f:\Working\中医\中医装备代码8-20出差回\2023-12-9-SWD&XWTT\Middlewares\Third_Party\LwIP\src\netif\ppp\pppol2tp.c", "C", 0, 874, 0, 0, 171, 135, 1180
"f:\Working\中医\中医装备代码8-20出差回\2023-12-9-SWD&XWTT\Middlewares\Third_Party\LwIP\src\netif\ppp\pppos.c", "C", 0, 608, 0, 0, 175, 93, 876
"f:\Working\中医\中医装备代码8-20出差回\2023-12-9-SWD&XWTT\Middlewares\Third_Party\LwIP\src\netif\ppp\upap.c", "C", 0, 446, 0, 0, 141, 91, 678
"f:\Working\中医\中医装备代码8-20出差回\2023-12-9-SWD&XWTT\Middlewares\Third_Party\LwIP\src\netif\ppp\utils.c", "C", 0, 748, 0, 0, 124, 88, 960
"f:\Working\中医\中医装备代码8-20出差回\2023-12-9-SWD&XWTT\Middlewares\Third_Party\LwIP\src\netif\ppp\vj.c", "C", 0, 451, 0, 0, 182, 63, 696
"f:\Working\中医\中医装备代码8-20出差回\2023-12-9-SWD&XWTT\Middlewares\Third_Party\LwIP\src\netif\slipif.c", "C", 0, 312, 0, 0, 191, 53, 556
"f:\Working\中医\中医装备代码8-20出差回\2023-12-9-SWD&XWTT\Middlewares\Third_Party\LwIP\system\OS\sys_arch.c", "C", 0, 325, 0, 0, 141, 39, 505
"f:\Working\中医\中医装备代码8-20出差回\2023-12-9-SWD&XWTT\Middlewares\Third_Party\LwIP\system\arch\bpstruct.h", "C++", 3, 0, 0, 0, 31, 3, 37
"f:\Working\中医\中医装备代码8-20出差回\2023-12-9-SWD&XWTT\Middlewares\Third_Party\LwIP\system\arch\cc.h", "C++", 36, 0, 0, 0, 34, 19, 89
"f:\Working\中医\中医装备代码8-20出差回\2023-12-9-SWD&XWTT\Middlewares\Third_Party\LwIP\system\arch\cpu.h", "C++", 6, 0, 0, 0, 31, 3, 40
"f:\Working\中医\中医装备代码8-20出差回\2023-12-9-SWD&XWTT\Middlewares\Third_Party\LwIP\system\arch\epstruct.h", "C++", 3, 0, 0, 0, 31, 3, 37
"f:\Working\中医\中医装备代码8-20出差回\2023-12-9-SWD&XWTT\Middlewares\Third_Party\LwIP\system\arch\init.h", "C++", 6, 0, 0, 0, 31, 8, 45
"f:\Working\中医\中医装备代码8-20出差回\2023-12-9-SWD&XWTT\Middlewares\Third_Party\LwIP\system\arch\lib.h", "C++", 4, 0, 0, 0, 31, 4, 39
"f:\Working\中医\中医装备代码8-20出差回\2023-12-9-SWD&XWTT\Middlewares\Third_Party\LwIP\system\arch\perf.h", "C++", 5, 0, 0, 0, 31, 3, 39
"f:\Working\中医\中医装备代码8-20出差回\2023-12-9-SWD&XWTT\Middlewares\Third_Party\LwIP\system\arch\sys_arch.h", "C++", 29, 0, 0, 0, 31, 13, 73
"f:\Working\中医\中医装备代码8-20出差回\2023-12-9-SWD&XWTT\Src\App\StringTransform.c", "C", 0, 266, 0, 0, 10, 36, 312
"f:\Working\中医\中医装备代码8-20出差回\2023-12-9-SWD&XWTT\Src\App\com.c", "C", 0, 270, 0, 0, 44, 23, 337
"f:\Working\中医\中医装备代码8-20出差回\2023-12-9-SWD&XWTT\Src\App\common.c", "C", 0, 674, 0, 0, 71, 76, 821
"f:\Working\中医\中医装备代码8-20出差回\2023-12-9-SWD&XWTT\Src\App\console.c", "C", 0, 604, 0, 0, 0, 92, 696
"f:\Working\中医\中医装备代码8-20出差回\2023-12-9-SWD&XWTT\Src\App\crc16.c", "C", 0, 229, 0, 0, 0, 199, 428
"f:\Working\中医\中医装备代码8-20出差回\2023-12-9-SWD&XWTT\Src\App\lcdTask.c", "C", 0, 462, 0, 0, 98, 140, 700
"f:\Working\中医\中医装备代码8-20出差回\2023-12-9-SWD&XWTT\Src\App\mqttTask.c", "C", 0, 375, 0, 0, 124, 61, 560
"f:\Working\中医\中医装备代码8-20出差回\2023-12-9-SWD&XWTT\Src\App\parameter.c", "C", 0, 256, 0, 0, 18, 65, 339
"f:\Working\中医\中医装备代码8-20出差回\2023-12-9-SWD&XWTT\Src\App\startDefaultTask.c", "C", 0, 23, 0, 0, 41, 9, 73
"f:\Working\中医\中医装备代码8-20出差回\2023-12-9-SWD&XWTT\Src\App\startLoopTask.c", "C", 0, 201, 0, 0, 30, 29, 260
"f:\Working\中医\中医装备代码8-20出差回\2023-12-9-SWD&XWTT\Src\Drivers\AHT15.c", "C", 0, 56, 0, 0, 6, 19, 81
"f:\Working\中医\中医装备代码8-20出差回\2023-12-9-SWD&XWTT\Src\Drivers\MS5637.c", "C", 0, 327, 0, 0, 30, 46, 403
"f:\Working\中医\中医装备代码8-20出差回\2023-12-9-SWD&XWTT\Src\Drivers\ad9833.c", "C", 0, 77, 0, 0, 44, 22, 143
"f:\Working\中医\中医装备代码8-20出差回\2023-12-9-SWD&XWTT\Src\Drivers\dac8831.c", "C", 0, 322, 0, 0, 145, 47, 514
"f:\Working\中医\中医装备代码8-20出差回\2023-12-9-SWD&XWTT\Src\Drivers\pca9554.c", "C", 0, 210, 0, 0, 68, 23, 301
"f:\Working\中医\中医装备代码8-20出差回\2023-12-9-SWD&XWTT\Src\Drivers\spiFlash.c", "C", 0, 271, 0, 0, 65, 33, 369
"f:\Working\中医\中医装备代码8-20出差回\2023-12-9-SWD&XWTT\Src\EC20_4G\EC20_4G.c", "C", 0, 182, 0, 0, 11, 36, 229
"f:\Working\中医\中医装备代码8-20出差回\2023-12-9-SWD&XWTT\Src\EC20_4G\EC20_4G.h", "C++", 24, 0, 0, 0, 0, 10, 34
"f:\Working\中医\中医装备代码8-20出差回\2023-12-9-SWD&XWTT\Src\WIFI\WIFI.h", "C++", 23, 0, 0, 0, 0, 7, 30
"f:\Working\中医\中医装备代码8-20出差回\2023-12-9-SWD&XWTT\Src\WIFI\WiFi.c", "C", 0, 222, 0, 0, 19, 11, 252
"f:\Working\中医\中医装备代码8-20出差回\2023-12-9-SWD&XWTT\Src\cjson\cJSON.c", "C", 0, 2350, 0, 0, 202, 424, 2976
"f:\Working\中医\中医装备代码8-20出差回\2023-12-9-SWD&XWTT\Src\cjson\cJSON.h", "C++", 145, 0, 0, 0, 95, 41, 281
"f:\Working\中医\中医装备代码8-20出差回\2023-12-9-SWD&XWTT\Src\ethernetif.c", "C", 0, 452, 0, 0, 277, 140, 869
"f:\Working\中医\中医装备代码8-20出差回\2023-12-9-SWD&XWTT\Src\freertos.c", "C", 0, 3, 0, 0, 42, 17, 62
"f:\Working\中医\中医装备代码8-20出差回\2023-12-9-SWD&XWTT\Src\lwip.c", "C", 0, 69, 0, 0, 116, 29, 214
"f:\Working\中医\中医装备代码8-20出差回\2023-12-9-SWD&XWTT\Src\main.c", "C", 0, 1698, 0, 0, 493, 324, 2515
"f:\Working\中医\中医装备代码8-20出差回\2023-12-9-SWD&XWTT\Src\mqtt\MQTTConnect.h", "C++", 93, 0, 0, 0, 37, 19, 149
"f:\Working\中医\中医装备代码8-20出差回\2023-12-9-SWD&XWTT\Src\mqtt\MQTTConnectClient.c", "C", 0, 128, 0, 0, 54, 33, 215
"f:\Working\中医\中医装备代码8-20出差回\2023-12-9-SWD&XWTT\Src\mqtt\MQTTConnectServer.c", "C", 0, 91, 0, 0, 39, 19, 149
"f:\Working\中医\中医装备代码8-20出差回\2023-12-9-SWD&XWTT\Src\mqtt\MQTTDeserializePublish.c", "C", 0, 54, 0, 0, 37, 17, 108
"f:\Working\中医\中医装备代码8-20出差回\2023-12-9-SWD&XWTT\Src\mqtt\MQTTFormat.c", "C", 0, 218, 0, 0, 15, 30, 263
"f:\Working\中医\中医装备代码8-20出差回\2023-12-9-SWD&XWTT\Src\mqtt\MQTTFormat.h", "C++", 18, 0, 0, 0, 15, 5, 38
"f:\Working\中医\中医装备代码8-20出差回\2023-12-9-SWD&XWTT\Src\mqtt\MQTTPacket.c", "C", 0, 255, 0, 0, 104, 54, 413
"f:\Working\中医\中医装备代码8-20出差回\2023-12-9-SWD&XWTT\Src\mqtt\MQTTPacket.h", "C++", 93, 0, 0, 0, 19, 22, 134
"f:\Working\中医\中医装备代码8-20出差回\2023-12-9-SWD&XWTT\Src\mqtt\MQTTPublish.h", "C++", 16, 0, 0, 0, 16, 7, 39
"f:\Working\中医\中医装备代码8-20出差回\2023-12-9-SWD&XWTT\Src\mqtt\MQTTSerializePublish.c", "C", 0, 74, 0, 0, 67, 29, 170
"f:\Working\中医\中医装备代码8-20出差回\2023-12-9-SWD&XWTT\Src\mqtt\MQTTSubscribe.h", "C++", 15, 0, 0, 0, 16, 9, 40
"f:\Working\中医\中医装备代码8-20出差回\2023-12-9-SWD&XWTT\Src\mqtt\MQTTSubscribeClient.c", "C", 0, 73, 0, 0, 42, 23, 138
"f:\Working\中医\中医装备代码8-20出差回\2023-12-9-SWD&XWTT\Src\mqtt\MQTTSubscribeServer.c", "C", 0, 58, 0, 0, 36, 19, 113
"f:\Working\中医\中医装备代码8-20出差回\2023-12-9-SWD&XWTT\Src\mqtt\MQTTUnsubscribe.h", "C++", 15, 0, 0, 0, 16, 8, 39
"f:\Working\中医\中医装备代码8-20出差回\2023-12-9-SWD&XWTT\Src\mqtt\MQTTUnsubscribeClient.c", "C", 0, 51, 0, 0, 38, 18, 107
"f:\Working\中医\中医装备代码8-20出差回\2023-12-9-SWD&XWTT\Src\mqtt\MQTTUnsubscribeServer.c", "C", 0, 52, 0, 0, 33, 18, 103
"f:\Working\中医\中医装备代码8-20出差回\2023-12-9-SWD&XWTT\Src\mqtt\StackTrace.h", "C++", 49, 0, 0, 0, 16, 14, 79
"f:\Working\中医\中医装备代码8-20出差回\2023-12-9-SWD&XWTT\Src\stm32h7xx_hal_msp.c", "C", 0, 588, 0, 0, 470, 225, 1283
"f:\Working\中医\中医装备代码8-20出差回\2023-12-9-SWD&XWTT\Src\stm32h7xx_hal_timebase_tim.c", "C", 0, 34, 0, 0, 65, 16, 115
"f:\Working\中医\中医装备代码8-20出差回\2023-12-9-SWD&XWTT\Src\stm32h7xx_it.c", "C", 0, 245, 0, 0, 246, 106, 597
"f:\Working\中医\中医装备代码8-20出差回\2023-12-9-SWD&XWTT\Src\strings\StringTransform.c", "C", 0, 295, 0, 0, 12, 43, 350
"f:\Working\中医\中医装备代码8-20出差回\2023-12-9-SWD&XWTT\Src\strings\StringTransform.h", "C++", 23, 0, 0, 0, 14, 15, 52
"f:\Working\中医\中医装备代码8-20出差回\2023-12-9-SWD&XWTT\Src\system_stm32h7xx.c", "C", 0, 120, 0, 0, 181, 66, 367
"Total", "-", 304183, 286587, 39, 8889, 274558, 107903, 982159